border_size=1
usage=map

Re, Gll^Fp, Gll^Fp, Gll^Fp, Gll^Fp, Gg, Wwg, Wog, Ce, Gll^Fp, Gs^Fds, Gll^Fmw, Gs^Fds, Gs^Fds, Gll^Fp, Re, Re, Gg, Gg, Gg, Gg, Gg, Gll^Fp, Gll^Fp, Gll^Fmw, Gs^Fds, Gs^Fds, Gll^Fp, Gs^Fds
Re, Re, Re, Re, Re, Gg^Fet, Wog, Wog, Ce, Gll^Fp, Gll^Fp, Gs^Fds, Gs^Fds, Gs^Fms, Gll^Fp, Re^Es, Re, Re, Gg, Gg, Gg, Gg, Gll^Fp, Gll^Fp, Gll^Fp, Gs^Fms, Gll^Fp, Gs^Fms, Gs^Fds
Gll^Fp, Re, Ch, Ch, Ch, Gg, Gg, Ce, Re, Gg, Gg, Gs^Fms, Gs^Fms, Gs^Fms, Gll^Fp, Gll^Fp, Gll^Fp, Re, Re, Re, Ce, Gg, Gg, Gll^Fp, Gg, Gll^Fp, Gll^Fp, Gs^Fms, Gll^Fp
Gll^Fp, Gg, Ch, Kh, Ch, Gg, Gg, Gg, Re, Gg, Gg, Gs^Fms, Gs^Fms, Gs^Fms, Gll^Fp, Gll^Fp, Gg, Re, Re, Gg, Gg^Efm, Ket, Ce, Gg, Gg, Gg, Gg, Gll^Fp, Gll^Fp
Gg, Gg, Re, Ch, Re, Re, Re, Re, Gll^Fp, Gg^Ve, Gg, Gg, Gg, Gll^Fp, Gs, Gg, Re, Re, Gll^Fp, Gll^Fp, Gg, Gs^Fms, Gs^Fms, Ce, Gg, Gg, Gll^Fp, Gll^Fp, Gs^Fms
Wog, Gg, Gg, Re, Re, Re^Es, Re, Gll^Fp, Gll^Fp, Gll^Fp, Gg, Gg, Gg, Gg, Gs^Efm, Re^Vct, Re, Re, Gg, Gll^Fp, Gll^Fp, Gs, Gg^Ve, Gs, Gg, Gll^Fp, Gll^Fp, Gs^Fms, Gs^Fms
Ce, Wog, Wog, Wog, Re, Gg, Gg, Re, Re, Gg^Fet, Gg^Efm, Gg, Re^Vct, Re, Re, Gg^Fet, Re, Gg, Gs^Vh, Gll^Fp, Gll^Fp, Gg, Gg, Gg, Gg, Gll^Fp, Gs^Fds, Gs^Fms, Gs^Fms
Gs, Ce, Ce, Ce, Re, Gg, Gll^Fp, Gg, Re, Gg, Gg, Gg^Efm, Gg, Gg, Gg^Fet, Re^Es, Re, Gg, Gg, Re, Gg, Gg, Gg, Gg, Gs, Gg^Fet, Gs^Fms, Gs^Fds, Gs^Fms
Gs, Gs, Gs, Gs, Gll^Fp, Gg, Gll^Fp, Gg, Ce, Re, Gs, Gs, Gg, Re^Vct, Re, Re, Gg, Re, Re, Re, Ce, Ce, Ce, Gg, Gll^Fp, Gll^Fp, Gll^Fp, Gs^Fms, Gs^Fms
Gll^Fp, Gs, Gll^Fp, Gll^Fp, Gll^Fp, Gll^Fp, Gll^Fp, Gll^Fp, Ce, Re, Re, Re^Es, Re, Re, Re, Re, Gg, Gg, Re^Vct, Re, Ce, 1 Ket, Ce, Gg, Gg, Gg, Gll^Fp, Gs^Fms, Gs^Fms
Gll^Fp, Gll^Fp, Gs^Fms, Gll^Fp, Gll^Fp, Wwg, Wwg, Gll^Fp, Wwg, Ce, Re, Re, Re, Re, Gg, Gs, Gll^Fp, Gg, Gll^Fp, Gg, Gs, Ce, Gg, Re, Re, Gg, Gll^Fp, Gll^Fp, Gll^Fp
Gs^Fms, Gll^Fp, Gll^Fp, Gs^Fms, Wog, Wog, Wog, Wwg, Gs^Vl, Re, Gs, Gs, Re, Re, Gg, Gll^Fp, Gll^Fp, Gll^Fp, Gll^Fp, Gll^Fp, Gg, Gg, Gg, Gg, Gd, Ce, Gll^Fp, Gs^Fds, Gs^Fds
Gll^Fp, Gll^Fp, Ss, Ss, Wog, Wog^Ewl, Wog, Wwg, Wwg, Gg, Gg, Gg, Re, Re, Re, Gg, Gg, Gll^Fp, Gg, Gg^Efm, Gg^Efm, Gg^Efm, Gg, Gg, Gs^Fms, Ce, Gll^Fp, Gs^Fds, Gll^Fp
Gll^Fmw, Gll^Fp, Gs^Fms, Ss, Ss, Wog, Wwg, Wog, Wwg, Gg, Gg, Re, Re, Gg, Gg, Re, Ce, Re, Ket, Gg, Ce, Gg, Ce, Gs^Fms, Ce, Ket, Gll^Fp, Gll^Fp, Gs^Fds
Gll^Fp, Gs^Fms, Gs^Fms, Ss, Gll^Fp, Wog, Gll^Fp, Gg, Gg, Gg, Re, Re, Gg, Gg, Gg, Gg, Gg, Ce, Gs, Ce, Gs, Ce, Gg, Ce, Re, Gg, Gll^Fp, Gll^Fp, Gll^Fp
Gll^Fp, Gs^Fms, Gll^Fp, Gll^Fp, Gs^Fms, Gs^Fms, Gll^Fp, Gll^Fp, Gg, Gg, Re, Gg, Gs, Gs, Gg, Gg, Gg, Gs, Gll^Fp, Gs, Gg, Gs, Gs^Fms, Gg, Gs^Fms, Re, Gg^Ve, Gll^Fp, Gll^Fp
Gs^Fms, Gll^Fp, Gs^Fms, Gll^Fp, Gll^Fp, Gll^Fp, Gs^Efm, Gs, Re^Es, Re, Gg, Gg, Gs, Gll^Fp, Gll^Fp, Gll^Fp, Gll^Fp, Gll^Fp, Gs^Fds, Gg, Gll^Fp, Gll^Fp, Gll^Fp, Gll^Fp, Gs^Fms, Gll^Fp, Gs^Fms, Gs^Fms, Gs^Fms
Gs^Fms, Gll^Fp, Gll^Fp, Gs^Fms, Gs, Gs, Gg, Re, Re, Gs, Gg, Gg, Gll^Fp, Gll^Fp, Gll^Fp, Gll^Fp, Gll^Fp, Gll^Fp, Gs^Fms, Gll^Fp, Gll^Fp, Gll^Fp, Gs^Fms, Gll^Fp, Gs^Fds, Gll^Fp, Gs^Fms, Gll^Fp, Gll^Fp
