border_size=1
usage=map

Xu, Xu, Xu, Xu, Xu, Xu, Xu, Xu, Xu, Qxu, Qxu, Uh, Uu, Ur, Xu, Xu, Xu, Xu, Xu, Xu, Qxu, Qxu, Qxu, Xu, Qxu, Xu, Xu, Xu, Xu, Xu, Xu, Xu, Xu, Xu, Xu, Xu, Xu, Xu, Xu, Xu, Xu, Xu, Xu, Xu, Xu, Xu
Xu, Xu, Xu, Xu, Xu, Xu, Xu, Xu, Xu, Qxu, Qxu, Uu^Vu, Uh, Urb, Uu, Xu, Uh, Xu, Uh, Uu^Uf, Qxu, Qxu, Qxu, Qxu, Qxu, Qxu, Qxu, Xu, Xu, Xu, Xu, Xu, Xu, Xu, Xu, Xu, Xu, Xu, Xu, Xu, Xu, Xu, Xu, Xu, Xu, Xu
Xu, Xu, Cud, 5 Kud, Cud, Cud, Cud, Xu, Xu, Xu, Xu, Qxu, Qxu, Uu, Uh, Uu, Ur^Es, Uu^Es, Uu, Uh^Uf, Qxu, Qxu, Xu, Xu, Xu, Qxu, Qxu, Xu, Xu, Xu, Xu, Xu, Xu, Xu, Xu, Xu, Xu, Xu, Xu, Xu, Xu, Xu, Xu, Xu, Xu, Xu
Xu, Xu, Uu, Uu, Uu, Uu, Cud, Xu, Xu, Xu, Xu, Qxu, Qxu, Cud, Uh, Uh, Ur, Uu, Uh, Qxu, Qxu, Qxu, Xu, Xu, Xu, Qxu, Qxu, Qxu, Qxu, Xu, Xu, Xu, Xu, Xu, Xu, Xu, Xu, Xu, Xu, Xu, Xu, Xu, Xu, Xu, Xu, Xos
Xu, Uh^Vu, Uu, Urb, Urb, Uu, Cud, Cud, Xu, Xu, Xu, Xu, Qxu, Qxu, Uh^Emf, Uu, Uu, Uh, Uh, Qxu, Qxu, Qxu, Xu, Xu, Xu, Xu, Xu, Xu, Qxu, Xu, Uue, Xu, Uhe^Uf, Xu, Uhe^Uf, Xu, Xu, Xu, Xu, Xu, Xu, Xu, Xu, Xu, Xu, Xu
Xu, Uh, Uh, Uu, Urb, Uu, Uu, Cud, Xu, Xu, Xu, Qxu, Qxu, Qxu, Rb^Uf, Urb, Uu, Uh, Uh, Uh^Vud, Uh, Xu, Xu, Xu, Xu, Xu, Wwf, Xu, Uue, Uue^Uf, Re, Rr, Rr, Uhe^Uf, Uhe, Xu, Xu, Xu, Xu, Xu, Xu, Xu, Xu, Xu, Xu, Xu
Xu, Cud, Cud, Cud, Uu^Br\, Uu, Uu, Xu, Xu, Xu, Uu, Qxu, Uh^Dr, Uh, Re^Es, Urb, Ur, Uu, Rb^Es, Uu, Xu, Xu, Xu, Xu, Xu, Wwg, Wog, Wwf, Wwg, Uue, Rr, Rr^Ii, Re, Uue, Uue, Uhe^Vu, Xu, Xu, Xu, Xu, Xu, Xu, Xu, Xu, Xu, Xu
Xu, Xu, Xu, Xu, Xu, Uu^Br\, Urb^Br|, Uu, Urb, Uu^Es, Urb, Uh^Dr, Uh, Re^Es, Uu, Uu, Cud, Ur, Ur, Rb^Es, Uu, Xu, Wwf, Wwg, Wwg, Wwg, Wog, Wog, Wog, Rr, Uue, Rr, Uhe^Uf, Uue^Uf, Uhe^Uf, Uhe^Uf, Xu, Xu, Xu, Xu, Xu, Xu, Xu, Xu, Xu, Xu
Xu, Xu, Xu, Xu, Uh^Es, Uu, Urb^Br|, Urb, Qxu, Urb, Urb, Uh, Ur, Ur, Xuc, Xuc, Xuc, Cud, Uh, Uu, Uu, Wwf, Wwg, Wog, Wog, Wog, Wog, Wog, Xu, Cud, Xu, Uhe^Uf, Uhe^Uf, Uhe^Uf, Uhe^Uf, Uhe^Uf, Xu, Xu, Xu, Xu, Xu, Xu, Xu, Xu, Xu, Xu
Xu, Xu, Xu, Uh^Vud, Uh^Es, Urb, Urb^Br|, Qxu, Qxu, Qxu, Urb, Urb, Uu^Br/, Uu^Br/, Xuc, Xuc, Xuc, Kud, Cud, Uu, Uu, Wwf, Wwg, Wog, Xu, Wog, Xu, Xu, Xu, Xu, Xu, Xu, Xu, Xu, Xu, Xu, Xu, Xu, Xu, Xu, Xu, Xu, Xu, Xu, Xu, Xu
Xu, Xu, Xu, Uh, Uu, Uu, Urb^Br|, Qxu, Qxu, Qxu, Urb^Br/, Urb^Br/, Uu, Xuc, Xuc, Xuc, Xuc, Xu, Xuc, Uu^Br\, Uu^Br\, Uu, Uh^Uf, Wwf, Xu, Xu, Xu, Xu, Xu, Xu, Xu, Xu, Xu, Xu, Xu, Xu, Xu, Xu, Xu, Xu, Xu, Xu, Xu, Xu, Xu, Xu
Xu, Xu, Xu, Xu, Cud, Urb^Br/, Rb, Urb^Br\, Urb^Br\, Urb^Br/, Uu^Br\, Uu^Br|, Rb^Es, Xuc, Xuc, Xuc, Xuc, Xuc, Xuc, Uh^Es, Uh^Es, Uu^Br|, Uu, Uh^Uf, Xu, Xu, Xu, Xu, Xu, Xu, Xu, Xu, Xu, Xu, Xu, Xu, Xu, Xu, Xu, Xu, Xu, Xu, Xu, Xu, Xu, Xu
Xu, Xu, Xu, Xu, Xu, Cud, Cud, Rb^Es, Urb, Urb, Uu, Uu^Br\, Uu^Br\, Rb^Es, Uh, Uh^Uf, Uh^Uf, Xuc, Uh^Es, Uh^Es, Uu, Uu^Br|, Uu, Xu, Xu, Xu, Xu, Xu, Xu, Xu, Cud, Xu, Cud, Xu, Xu, Xu, Xu, Xu, Qxu, Qxu, Qxu, Xu, Xu, Xu, Xu, Xu
Xu, Xu, Xu, Xu, Xu, Xu, Xu, Xu, Xu, Rb^Es, Uu^Vud, Rb, Uu, Uu^Br\, Uu^Br\, Urb, Urb, Uh, Uu^Es, Uh, Uu^Br/, Uu^Br\, Xu, Xu, Xu, Xu, Xu, Xu, Xu, Cud, Cud, Kud, Cud, Cud, Xu, Xu, Xu, Xu, Xu, Qxu, Qxu, Qxu, Xu, Xu, Xu, Xu
Xu, Xu, Xu, Xu, Xu, Xu, Xu, Xu, Xu, Xu, Xu, Xu, Xu, Uh, Uh, Uu^Br\, Rb^Br\, Rb^Es, Rb^Br/, Uu^Br/, Uh, Xu, Xu, Xu, Uu^Br\, Uu^Es, Uu^Es, 3 Xu, Uu^Br/, Uu^Br|, Rr, Rr, Uu^Es, Xu, Xu, Xu, Xu, Xu, Xu, Qxu, Qxu, Qxu, Xu, Xu, Xu, Xu
Mm^Xm, Xu, Mm^Xm, Xu, Mm^Xm, Xu, Xue, Xu, Xu, Xu, Xu, Xu, Xu, Xu, Xu, Xu, Xu, Rb^Br/, Xu, Uu, Xu, Xu, Xu, Xu, Xu, Uu^Br\, Uu^Br\, Uu^Br/, Rr, Rr, Uu, Rr, Rr, Uu, Uu^Vud, Xu, Xu, Xu, Qxu, Qxu, Qxu, Qxu, Xu, Xu, Xu, Xu
Mm^Xm, Mm^Xm, Mm, Mm^Xm, Mm^Xm, Mm^Xm, Mm^Xm, Xue, Xu, Xu, Xue, Xu, Xue, Xu, Xue, Xu, Xu, Xu, Xu, Xu, Xu, Xu, Xu, Xu, Xu, Xu, Uu^Br|, Uu, Rr^Es, Uu, Xu, Uu, Uu, Rr, Rr, Xu, Qxu, Xu, Qxu, Qxu, Qxu, Qxu, Xu, Xu, Xu, Xu
Hh, Mm, Mm, Mm, Mm, Mm^Xm, Mm^Xm, Xue, Xue, Xue, Xue, Xue, Xue, Xue, Uhe^Uf, Xue, Xue, Xue, Xue, Xue, Xue, Xu, Xu, Xu, Xuc, Xu, Uu^Br|, Rr^Es, Rr, Xu, Xu, Xu, Xu, Uu, Qxu^Bcx\, Qxu^Bcx\, Qxu, Qxu, Qxu, Qxu, Xu, Qxu, Xu, Xu, Xu, Xu
Mm, Mm, Hh, Hh, Hh^Fp, Mm, Mm, Xue, Xue, Xue, Cud, Xue, Uue, Uhe^Uf, Rr^Es, Uhe^Uf, Uue, Xue, Xue, Xue, Xue, Xue, Xue, Xu, Xuc, Xu, Uu^Br\, Rr, Rr, Xu, Xu, Xu, Xu, Qxu, Qxu, Qxu, Qxu, Qxu, Qxu^Bcx\, Qxu, Xu, Xu, Xu, Xu, Xu, Xu
Hh, Mm, Hh^Fmf, Hh, Hh, Hh^Fds, Hh, Mm, Xue, Cud, Hhd, Uue, Rr, Rr, Uue^Es, Rr^Es, Rr^Es, Uue^Es, Uue, Uhe, Uhe, Uhe, Uhe, Xue, Xue, Xu, Xu, Rr^Br|, Rr^Br\, Uu, Xu, Xu, Xu, Xu, Qxu, Qxu, Qxu, Qxu^Bcx\, Uu, Rr, Rr, Cud, Cud, Xu, Xu, Xu
Hh, Hh^Fmf, Gll^Fmf, Gll^Fmf, Hh^Vhh, Hh, Gs, Gg, Gs, Hhd, Re, Rr, Uue, Uue, Re^Uf, Uue, Uue, Rr, Rr, Rr, Rr, Re, Re, Uu, Uu, Xu, Uu, Uu, Uu^Br|, Re^Es, Uu, Xu, Xu, Xu, Qxu, Qxu, Xu, Xu, Xu, Uu, Rr, Uu, Uu, Cud, Xu, Xu
Gll, Gll^Fmf, Gs^Efm, Gll^Efm, Gll, Gll^Edb, Re, Re, Re, Re, Hhd, Uue, Cud, Cud, Xue, Xue, Xue, Uue, Uue, Rr, Uue, Rr, Rr, Rr, Rr, Rr, Rr, Uu, Cud, Re^Es, Re, Uu^Vud, Xu, Xu, Qxu, Qxu, Qxu, Xu, Xu, Cud, Cud, Rr, Rr, Uu, Rr, Xu
Rd, Gs, Rd, Gs, Re, 1 Re^Es, Gg^Efm, Gg^Efm, Gg, Gs, Xue, Xue, Xue, Xue, Xue, Xu, Xu, Xue, Xue, Xu, Xue, Xu, Xu, Uu, Uu, Rr, Rb, Cud, 2 Kud, Cud, Uu, Uu, Xu, Xu, Xu, Qxu, Qxu, Xu, Xu, Xu, Xu, Cud, Xu, Rr, Uu, Rr
Gg, Rd, Gg^Efm, Re, Gs, Gg, Hh, Gs, Hh, Mm, Xue, Xue, Xue, Xue, Xue, Xue, Xue, Xu, Xue, Xue, Xue, Xu, Xue, Xu, Uh^Uf, Uu^Vud, Rb, Cud, Cud, Cud, Uu, Uu^Uf, Xu, Xu, Xu, Qxu, Qxu, Qxu, Xu, Xu, Xu, Xu, Xu, Xu, Xu, Uu
Gll^Efm, Gg^Efm, Gd^Efm, Gs, Hh, Gs, Hh, Hh, Mm^Xm, Mm^Xm, Xue, Xue, Xue, Xue, Xue, Xue, Xue, Xue, Xue, Xue, Xue, Xu, Xu, Xu, Uh^Uf, Uu, Uu, Uu, Uu, Uu, Uh, Uh, Xu, Xu, Xu, Qxu, Qxu, Qxu, Xu, Xu, Xu, Xu, Xu, Xu, Xu, Xu
Gll, Gll, Gll, Gd^Fp, Hh^Fmw, Hh, Mm, Mm, Mm^Xm, Mm^Xm, Xue, Xue, Xue, Xue, Xue, Xue, Xue, Xue, Xue, Xue, Xu, Xu, Xu, Xu, Xu, Uh^Uf, Xu, Uh, Uh, Uh, Xu, Xu, Xu, Xu, Wog, Wog, Qxu, Qxu, Xu, Xu, Xu, Xu, Xu, Xu, Xu, Xu
Gll^Fp, Gll^Fp, Gs^Efm, Gll^Fmf, Hh^Fmf, Hh, Mm, Mm, Xue, Xue, Xue, Xue, Xue, Xue, Xue, Xue, Xue, Xue, Xue, Xue, Xu, Xu, Xu, Xu, Xu, Xu, Xu, Xu, Xu, Xu, Xue, Xu, Xu, Wog, Wog, Qxu, Xu, Xu, Xu, Xu, Xu, Xu, Xu, Xu, Xu, Xu
Gll^Fp, Gll^Efm, Gg^Efm, Gll^Fp, Hh, Mm, Mm^Xm, Xue, Xue, Xue, Xue, Xue, Xue, Xue, Xue, Xue, Xue, Xue, Xue, Xue, Xu, Xu, Xu, Xu, Xu, Xu, Xu, Xu, Xu, Xue, Xu, Xu, Xu, Wog, Wog, Mm^Xm, Xu, Xu, Xu, Xu, Xu, Xu, Xu, Xu, Xu, Xu
Gll, Gg^Efm, Gs, Hh, Mm, Mm, Mm^Xm, Xue, Xue, Xue, Xue, Xue, Xue, Xue, Xue, Xue, Xue, Xue, Xue, Xue, Xu, Xu, Xu, Xu, Xu, Xu, Xu, Xu, Xu, Xu, Xu, Xu, Xu, Wog, Mm, Mm^Xm, Mm^Xm, Mm^Xm, Xu, Xu, Xu, Xu, Xu, Xu, Xu, Xu
Gg, Gg^Efm, Gs^Fms, Hh^Fmf, Mm, Mm^Xm, Mm^Xm, Xue, Xue, Xue, Xue, Xue, Xue, Xue, Xue, Xue, Xue, Xue, Xue, Xue, Xu, Xu, Xu, Xu, Xu, Xu, Xu, Xu, Xu, Xu, Xu, Xu, Mm^Xm, Wog, Mm, Mm, Mm, Mm^Xm, Xu, Xu, Xu, Xu, Xu, Xu, Xu, Xu
Gs, Gs^Fds, Ww, Ww, Hh, Mm, Mm, Mm^Xm, Mm^Xm, Xue, Xue, Xue, Xue, Xue, Xue, Xue, Xue, Xue, Xue, Xue, Xu, Xu, Xu, Xu, Xu, Xu, Xu, Xu, Xu, Xu, Xu, Mm^Xm, Hh^Dr, Wog, Hh^Fds, Hh^Dr, Mm, Xu, Xu, Xu, Xu, Xu, Xu, Xu, Xu, Xu
Gs, Ww, Gs, Gg^Fmf, Hh^Fmf, Hh, Hh^Fp, Mm, Mm, Mm^Xm, Mm^Xm, Xue, Xue, Xue, Xue, Xue, Xue, Xue, Xue, Xue, Xu, Xu, Xu, Xu, Xu, Xu, Xu, Xu, Xu, Xu, Mm^Xm, Mm, Wog, Wog, Gs^Fds, Hh, Mm, Xu, Xu, Xu, Xu, Xu, Xu, Xu, Xu, Xu
Ww, Ww, Gg, Gg^Efm, Gg, Hh^Fp, Gll^Fp, Mm, Mm, Mm, Mm^Xm, Xue, Xue, Xue, Xue, Xue, Xue, Xue, Xue, Xue, Xu, Xu, Xu, Xu, Xu, Xu, Xue, Xu, Xue, Xu, Mm^Xm, Mm, Wog, Gs^Fds, Gg, Hh, Hh, Mm^Xm, Mm^Xm, Mm^Xm, Xu, Xu, Xu, Xu, Xu, Xu
