border_size=1
usage=map

Gd^Fp, Gg^Fds, Gll^Fds, Gg^Fds, Gll^Fp, Gll^Fds, Gll^Fms, Gll^Fds, Gll^Fp, Gll^Fp, Gll^Fms, Gll^Fp, Gd^Fmw, Gll^Fp, Gll^Fmw, Gd, Ss, Ss, Hh, Ss, Hh^Fds, Hh^Fms, Gs^Fms, Gll^Fp, Gg^Efm, Gll^Fp, Gll^Fp, Gd^Fmw, Gll^Fp, Gll^Fp, Gll^Fp, Gg, Gs, Re, Rd, Gg, Gg, Gll^Fp, Hh^Fp, Hh^Fds, Hh^Fp, Hh^Fds, Hh^Fds, Mm, Mm, Mm, Mm^Xm, Mm^Xm, Xu
Gd^Fp, Gd^Fp, Gd^Fp, Gd^Fp, Gd^Fp, Gll^Fp, Rd, Ds^Fp, Gg^Fds, Gll^Fp, Gll^Fet, Gll^Fp, Gd^Fp, Gll^Fp, Rd, Gll^Fp, Re^Gvs, Ss, Gll^Fp, Hh^Fds, Hh^Fds, Hh^Fms, Hh^Fp, Gs^Fms, Gs^Fms, Gg^Efm, Gg, Gs^Fds, Gs^Fds, Gll^Fp, Gd, Gd, Re, Rd, Gs, Gg, Gd^Vo, Gll^Fp, Hh^Fds, Hh^Fds, Co, Hh^Fp, Hh^Fp, Hh^Fds, Mm, Mm^Xm, Xu, Xu, Uh
Gll^Fds, Gd^Fp, Gg^Fet, Gg, Ce, Ce, Ce, Rd, Gd, Gg^Vct, Gg^Fds, Gll^Fp, Gll^Fms, Gg^Fms, Hh, Gg^Fp, Gll^Fp, Gll^Fp, Hh^Fmw, Hh^Fds, Gs^Fds, Gll^Fds, Hh, Hh, Gs^Fms, Gg, Gg, Gs^Fms, Gll^Fds, Gll^Fds, Gll^Fp, Gg, Gs, Rd, Rr, Gs, Gd, Gs^Efm, Re^Gvs, Co, 3 Ko, Co, Hh^Fp, Mm, Mm, Mm^Xm, Uh, Uh, Xu
Ww, Gll^Fds, Gll^Fds, Gg, Ce, 1 Ke, Ce, Ds, Ds, Gs, Gs, Gll^Fds, Gll, Gll^Fms, Hh, Hh, Gll^Fp, Hh^Fp, Hh, Gll^Fmw, Gg, Gs, Gs^Efm, Gg^Efm, Gs^Fds, Gs^Fds, Gd^Fds, Gll^Fms, Gll^Fds, Gll^Fds, Gll^Fms, Gll^Fp, Gll^Fp, Rd, Rr, Gg, Gs, Gd, Re^Gvs, Re^Gvs, Co, Co, Gs, Gd^Vo, Gd, Hh^Fp, Hhd, Hhd, Mm^Xm
Gll^Fds, Ww, Re, Gll, Gg, Ce, Hh, Hh, Hhd, Gs^Ecf, Gg, Gg, Gg, Gll, Hh, Gll^Fp, Gd^Fms, Hh^Fms, Hh^Fms, Gll^Fp, Gg, Gg, Gll^Fp, Gll^Fp, Gs^Fms, Gd^Fds, Gd^Fms, Gd^Fms, Gd^Fms, Gll^Fds, Gll^Fms, Gll^Fp, Gll^Fp, Re, Rd, Gs^Es, Gs, Re^Gvs, Re^Gvs, Re^Gvs, Hhd, Gs, Hh^Fds, Gd, Mm, Gd, Hh, Mm, Mm
Rd, Wo^Bw/, Re, Re, Rd, Rd, Re, Hh^Vct, Re, Re, Re, Gs, Re, Gs, Gg, Gll^Fp, Gll^Fp, Gll^Fp, Gs^Fms, Gll^Fp, Gll^Es, Gg, Gll^Fp, Gg^Fet, Gll^Fp, Gd^Fms, Gs, Gd^Fms, Gll^Fp, Gll^Fms, Gll^Fp, Gs^Fms, Gs^Fms, Re, Rd, Gg, Gs, Re^Gvs, Re^Gvs, Hhd, Mm, Mm, Mm, Mm, Mm, Mm, Gs^Fms, Gll^Fp, Gll^Fp
Gll^Fp, Ww, Gg, Rd, Gg^Vct, Re^Es, Gg^Efm, Re, Gs, Ds, Gg, Re, Ds, Rr, Rr, Gg, Gg, Gg^Es, Gs, Gll^Fds, Gs^Fds, Gs^Fms, Gs^Fms, Gll^Fp, Gg, Gs, Gs, Gs^Efm, Gg^Fp, Gll^Fmw, Re, Gs^Fms, Re, Rd, Gs, Gs, Hh^Fp, Gd, Gd, Hhd, Mm, Mm, Mm, Mm, Mm, Rd, Hh^Fms, Gs^Fms, Gs^Fms
Ww, Ww, Gd, Gd, Gs, Gg, Gs, Gs, Gs, Gs, Gs, Gg^Fds, Gg^Fms, Gg, Gg, Rp, Re^Es, Gg, Re, Gs^Fds, Gll^Fp, Gll^Fds, Rd, Gg, Rd, Gg, Rd, Re, Re, Re, Rd, Re, Gd^Fmw, Rd, Gll^Fp, Gg, Hh, Rb^Fdw, Gs, Hhd^Es, Hh^Fp, Hh, Mm, Mm, Mm, Mm, Hh^Fp, Gll^Fp, Gs^Fms
Ww, Gg, Gg, Gd, Gll^Fp, Gs, Gll^Fp, Gg^Fp, Gll^Fp, Gs^Efm, Hh, Hh^Fds, Mm, Mm, Re^Gvs, Re^Gvs, Re, Rd, Rd, Rd, Rd, Rd, Rd, Rd, Rd, Rd, Gs^Fp, Re, Gll^Fmw, Gd^Fp, Gd^Fmw, Gd^Fmw, Gll^Fp, Gll^Fp, Gg, Gg, Gs, Re, Hhd, Gd^Vo, Hh, Hh^Fp, Mm, Mm, Mm, Mm, Hh, Hh, Gll^Fp
Ds, Ds, Gs, Gd, Gll^Fmw, Gll^Fmw, Gll^Fmw, Gg^Fp, Hhd, Ds, Mm, Mm, Mm, Mm, Re^Gvs, Rb^Gvs, Gg, Gd, Gg, Gs, Gs, Gd, Gg, Gg, Rd, Rd, Ds, Gs^Fp, Gll^Fp, Gll^Fp, Gll^Fp, Gll^Fp, Gs^Fms, Gll^Fp, Gs^Fp, Gs, Gd^Es, Hhd, Hh, Hh, Mm, Mm, Mm, Mm, Hh, Hh, Hh^Fp, Gll^Fp, Gs^Fms
Gg, Gg, Gs, Gd, Gll^Fp, Gs^Fds, Gs^Fds, Gll^Fp, Hh, Hh, Mm, Mm^Xm, Mm, Hh, Hh^Fms, Rb^Gvs, Gg^Fp, Gs, Ww, Ds, Hh, Wwf^Em, Wo, Wo, Wo^Bsb|, Ds, Wo, Ds, Gg, Gll^Fp, Gll^Fp, Re^Fms, Re^Fp, Gll^Fp, Gd^Efm, Gd, Gd, Gg, Hh, Mm, Mm, Mm, Mm, Mm, Mm, Hh^Fms, Hh^Fms, Gll^Fp, Hhd
Gs, Gs, Gd^Fp, Gd^Fp, Gll^Fp, Gs^Fds, Gll^Fp, Gll^Fp, Hh, Mm, Mm, Mm^Xm, Mm, Hhd, Hh^Fp, Gll^Fp, Gll^Fp, Gg, Wo, Wo, Wo, Wo, Wo, Wo^Ewf, Wo^Bsb|, Wo, Wo, Wwf, Gs^Vhr, Gg, Gg, Gg, Gs, Gs^Fp, Gd, Hhd^Fmw, Hhd^Fmw, Hh^Fds, Hh^Fp, Mm, Mm, Mm, Mm, Mm, Mm, Hh, Gll^Fp, Gll^Fp, Gs
Gd, Gs, Gd^Fp, Gll^Fp, Gll^Fp, Gll^Fp, Gll^Fp, Hh, Hh, Mm, Mm, Mm^Xm, Mm^Xm, Mm, Mm, Hh, Gs, Gg^Es, Ds, Wot^Ewf, Wo, Wo, Wo, Wo, Wo^Bsb|, Wo, Wot, Re^Gvs, Re^Gvs, Re^Gvs, Re^Gvs, Gs, Gs, Gs, Gg, Gs, Gs, Hh^Fmw, Hhd^Fmw, Hh, Gs, Gd^Vo, Hh, Mm, Gs, Hh, Gs, Gll^Fp, Gll^Fp
Gll^Fp, Gd^Fp, Gg^Fms, Gg^Fms, Gll^Fms, Gll^Fp, Gll^Fp, Gll^Fp, Hh, Rd, Hh^Vhh, Mm, Mm, Mm, Mm, Hh, Gg, Gg, Gg^Es, Ds, Gg, Gg, Gg^Em, Wwf, Re, Wwf, Ds, Wwf, Re, Rb^Gvs, Gs, Gs, Gs, Gg^Es, Gg^Efm, Gg^Es, Gg, Hhd^Fmw, Hh, Gg, Gll^Fp, Gs, Hhd, Hh^Fms, Hh, Hh^Fms, Gll^Fp, Gs, Mm
Gg^Fms, Gg^Fms, Gll^Fp, Gg^Fp, Gll^Fmw, Gll^Fp, Gd^Fp, Gll^Fp, Ds, Ss, Ss, Mm, Mm, Mm, Hhd, Hh, Hh^Fms, Hh^Fp, Gg, Gs, Re^Vhr, Gs, Re, Re, Rd^Es, Gs, Rd, Rd, Rd, Re, Gg^Efm, Gd, Gd, Gg, Gg, Gg, Gg, Hhd, Gll^Fp, Gg, Gll^Fp, Hh^Fp, Mm, Hhd, Mm, Gs^Efm, Gll^Fp, Mm, Mm
Gll^Fp, Gll^Fp, Gll^Fmw, Gll^Fp, Gd^Fp, Gll^Fmw, Gll^Fmw, Gll^Fp, Gll^Fp, Ss, Ss, Hhd, Gd^Fp, Hh, Hh^Fp, Hh^Fet, Hh^Fms, Gs^Fds, Re, Gll, Re, Re, Gd, Gd, Rd, Rd, Gd^Es, Gs, Gg, Gg, Gg, Gg, Gll^Fp, Gg, Rp, Gs, Gs, Gll^Fp, Gll^Fp, Hh^Fms, Gll^Fp, Gll^Fp, Hh, Mm, Mm, Gll^Fp, Gll^Fp, Gll^Fp, Gll^Fp
Gll^Fp, Gll^Fp, Gll^Fmw, Gll^Fmw, Gll, Gll^Fp, Gd^Fp, Gll^Fp, Gd^Fp, Gd^Fp, Gd^Fp, Gd^Fp, Gd^Fp, Gll^Fp, Re^Fp, Re^Fds, Re^Fms, Re^Fp, Gg^Fds, Gg^Fds, Re, Re, Gg, Gg, Gll^Fp, Gd, Gg, Gs^Fms, Gs^Fds, Gg, Gs^Fms, Gg, Gg, Gll^Fp, Gll^Fp, Rp, Gs^Em, Gll^Fp, Gs, Gll^Fp, Gll^Fmw, Gll^Fp, Gll^Fmw, Mm, Gll^Fp, Gll^Fp, Gll^Fp, Gll^Fp, Gll^Fp
Gll^Fp, Gll^Fp, Gll, Gs, Gs^Vl, Gd^Fmw, Gd^Fmw, Gll^Fmw, Gs^Fms, Gll^Fp, Gll, Gll^Fp, Re, Re^Fp, Re, Gs^Fms, Re, Gs, Re, Re, Gs, Gs, Gd, Gd^Fds, Gll^Fmw, Gd^Fp, Gll^Fmw, Gg, Gll^Fp, Gs^Fms, Gll^Fms, Gg, Ss, Ss, Gll^Fp, Gs, Gd, Gll^Fp, Gs, Gll^Fp, Gs^Fms, Gll^Fp, Gll^Fp, Gll^Fp, Gll^Fmw, Gll^Fp, Gs^Fms, Gs^Fms, Mm
Gll^Fp, Gll^Fmw, Gs^Fmw, Gs^Es, Gs, Gd, Gll^Fp, Gd^Fp, Gs^Fms, Gll^Fp, Gg^Fms, Re, Re, Re, Re, Re, Gll^Fp, Re, Gll^Fp, Gs, Gll, Gs^Es, Gg, Gd, Gd^Fmw, Gll^Fp, Gd^Fmw, Hh^Fms, Gs^Fds, Hh^Fds, Gs^Fds, Gs, Ss, Gg, Ss, Gll^Fp, Gd, Chr, Khr, Gll^Fp, Gd, Chr, Chr^Dr, Gll^Fp, Gll^Fmw, Gll^Fmw, Gs^Fms, Gll^Fp, Hh^Dr
Gll^Fp, Gll^Fp, Gll, Gs^Es, Gd, Gll^Fp, Gll^Fp, Gd^Fp, Gll^Fp, Gs^Fms, Gll^Fp, Rd, Gll^Fp, Gll^Fp, Gll^Fds, Gll^Fds, Gd^Fms, Gll^Fp, Gg^Fds, Gll, Gll, Gs, Gll, Gll, Gd, Gd^Fmw, Gll^Fp, Hh^Fms, Gll^Fms, Gll^Fp, Gll^Fms, Gg^Fds, Gll^Fp, Gll^Fp, Gll^Fp, Gd, Gd, Chr^Dr, Chr^Es, Rp, Gd, Chr, Gll^Fp, Gll^Fp, Gll^Fp, Gs^Fms, Gll^Fp, Gs^Fms, Hh^Fp
Gll^Fmw, Gll^Fp, Gd^Fp, Gd^Fmw, Gll^Fmw, Gll^Fmw, Gll^Fp, Gll^Fp, Gg, Gd^Fp, Re, Rd, Gd^Es, Gd, Gs, Gs^Fms, Gll^Fmw, Gd^Fmw, Gd^Fp, Gg^Fp, Gll^Fp, Gll^Fp, Gll^Fp, Gs, Gd, Gg, Gll^Fp, Gg^Fmw, Gll^Fp, Gg^Fms, Gg^Fet, Gll^Fp, Gd^Fp, Gd^Fmw, Gll^Fp, Gll^Fp, Gll^Fp, Gs^Vc, Gll^Fp, Chr, Re, Gs, Gll^Fp, Gll^Fp, Gs^Fms, Gll^Fp, Hh^Fp, Hh^Fds, Hh^Fp
Gll^Fp, Gd^Fp, Gll^Fp, Gll^Fp, Gll^Fp, Gll^Fp, Gs, Gs^Es, Gll, Rd, Rb, Gs, Gg, Gd, Gg, Gg^Fp, Hh^Fms, Gd^Fp, Gll^Fp, Hhd, Hhd, Hh^Fp, Gll, Gg, Gs, Gs, Gg, Gll^Fp, Gs^Fms, Gll^Fms, Gg^Efm, Gll^Fp, Gll^Fp, Gd^Fp, Hhd^Fp, Hhd^Fms, Gll^Fms, Gs^Fms, Gs^Fms, Gll^Fp, Gs^Fms, Rp, Rp, Gs, Gs, Hh, Hh, Hh^Fp, Mm
Gd^Fp, Gd^Fp, Gll^Fp, Gll^Fp, Gll^Fp, Gll^Fp, Gs, Gs, Re, Re, Gs, Gs, Gg, Hh^Fmw, Hh, Hh^Fms, Hh^Fms, Hh^Fds, Gll^Fp, Hhd^Fp, Hhd^Fp, Hhd, Gll^Fp, Gs, Gg, Gs, Gg, Gll^Fp, Gg, Gd, Gll, Gg^Es, Gll, Gll^Fp, Hhd^Fds, Hhd^Fds, Gll^Fp, Gll^Fmw, Gs^Fms, Gll^Fp, Gll^Fp, Gs, Gs^Fms, Rp, Gs^Efm, Hhd, Hh, Mm, Mm^Xm
Gd^Fp, Gd^Fp, Gll^Fp, Gll^Fp, Gll^Fp, Gll^Fp, Gs, Re, Gg, Gll^Fp, Gll^Fms, Gll^Fp, Gg, Gg, Gg, Gd^Vhr, Gd, Hh, Gll^Fmw, Hhd^Fp, Hhd^Fp, Gll^Fp, Gll^Fp, Gll^Fp, Gd, Gd, Gd, Gs, Gs, Gs, Gs, Gll, Gll^Fp, Gs^Fms, Gll^Fp, Hh^Fmw, Hh^Fmw, Gll^Fp, Gll^Fp, Gll^Fp, Gll^Fp, Hh^Fms, Hhd, Rp, Gd, Mm, Mm^Xm, Mm, Mm
Gll^Fp, Gd^Fp, Gll^Fp, Gll^Fp, Gg, Gs, Re, Re, Gg, Gd^Fp, Gll^Fms, Gll^Fp, Gg, Gs, Gd^Es, Gs, Gs, Gll^Fp, Gll^Fmw, Gll^Fmw, Hhd^Fms, Gs^Fms, Gd^Fetd, Gll, Gg, Gd^Es, Gg^Es, Gll, Gll, Gll, Hh, Gs^Fms, Hh^Fp, Gll^Fp, Hh^Fds, Hh^Fms, Hh^Fp, Hh, Hh^Fp, Gll^Fp, Gd, Hh, Hh, Rd, Gs, Gd, Mm, Mm, Mm
Gll^Fp, Gll^Fp, Gll^Fp, Gll^Fp, Gs, Gd^Vct, Re, Rd, Gs, Gg, Gll^Fp, Gll^Fp, Gd, Gs, Gd, Gs, Gs, Gll^Fp, Gll^Fp, Gll^Fms, Gll^Fms, Gll^Fp, Gll^Fp, Gll, Gll^Fp, Gs^Es, Gs, Gg, Gd, Gs, Gll^Fp, Gll^Fp, Gs^Fds, Gg^Fp, Gll^Fp, Gg^Fp, Gll^Fp, Gg, Gll, Gg, Gg, Gg, Rd, Re, Gs, Gd, Mm, Mm, Mm
Gll^Fp, Gll^Fp, Gll^Fp, Gs, Gd, Gd, Re, Rd, Gg, Gs^Vct, Gs, Gg, Gs, Gs, Gg^Es, Gg, Gll^Fp, Gll^Fp, Gll, Gll^Fp, Gd^Fp, Gll^Fds, Gll^Fmw, Gll^Fp, Gll^Fmw, Gs, Re, Gd^Es, Gd, Gs, Gs^Fms, Gs^Fms, Gll^Fp, Gll^Fp, Gg, Gll^Fp, Gd, Gs, Gd^Es, Gll, Gg, Re, Re, Re, Hh, Hh, Mm, Mm, Mm
Gll^Fp, Gll^Fp, Gs, Gs, Re, Re^Es, Ce, Re, Re, Re, Rb, Gs^Es, Gg, Gs, Gll^Fp, Gs, Gs, Gd, Gd, Gll^Fp, Gd, Gll^Fp, Gll^Fmw, Gll^Fmw, Gs^Fds, Gll^Fp, Gg, Gd, Gg, Gll^Fp, Gll^Fp, Gs^Fms, Gg, Gd, Gd, Gd, Gs, Gd, Gg^Es, Gg, Re, Re, Gs, Gs, Hh, Mm, Mm, Mm, Mm
Gll^Fp, Gll^Fp, Gll^Fp, Rb, Gs, Ce, 4 Ke, Ce, Gs, Gg^Vct, Gg, Rb, Rb, Gg, Gll^Fp, Gll^Fp, Gd, Gd, Gg, Gd, Gd, Gll^Fp, Gll^Fp, Gll^Fmw, Gll^Fmw, Gll^Fp, Re, Gs, Gg, Gll^Fp, Gll^Fp, Gs^Fds, Gg, Gd, Gg, Gll^Fp, Gs, Gs, Re, Re, Gll, Gg, Gs, Gs, Hh, Mm, Mm, Mm, Hh
Gg, Gll^Fp, Gll^Fp, Rb, Re, Ce, Ce, Ce, Gll, Gs, Gg, Gg, Gll^Fp, Rb, Re, Gll^Fp, Gg, Gd, Gg, Gg, Gll^Fp, Gll^Fp, Gg, Gll^Fp, Gg, Gg, Gs^Efm, Gs^Efm, Gs, Gs, Gg, Gll^Fp, Gll^Fp, Gg, Gll^Fp, Gs, Gg, Re, Gll^Fp, Gll^Fp, Gll^Fp, Gg^Es, Gg^Fp, Hh^Fp, Hh^Fp, Mm, Mm, Mm, Hh
Gs, Gll^Fp, Gd, Gg^Es, Re, Gs, Gd, Gg, Gll^Fp, Gg, Gg, Gll^Fp, Gll^Fmw, Gll^Fms, Gll^Fp, Re, Gll^Fp, Gll^Fp, Gg, Gg, Gs, Gg^Es, Gs, Gll^Fp, Gs, Gg, Gg, Re, Gd, Gd, Gs, Gll^Fp, Gll^Fp, Gg, Gg, Gs, Re, Re, Gll^Fp, Gll^Fp, Gs^Fms, Gll^Fms, Gll^Fp, Hh^Fp, Hh, Hh, Hh, Hh, Hh
Re, Gs, Re, Re, Re, Gs^Vct, Gg, Gd, Gll, Gll^Fp, Gll^Fp, Gll^Fp, Gll^Fmw, Gll^Fmw, Gll^Fp, Re, Re, Rb, Rb, Rb, Rb, Gg, Re, Gs, Gg, Gs, Gs, Gd, Gd, Gs, Gg, Gs, Gs, Gg, Rb, Rb, Gg, Gll^Fp, Gll^Fp, Gs^Fms, Gd, Gs^Fms, Gll^Fp, Gg, Gg, Gg, Gg, Hh, Gg
Re, Re, Gs, Gg, Gs, Gs, Gd, Gg, Gs, Gll, Gd, Gll^Fmw, Gll^Fmw, Gll^Fmw, Gll^Fp, Gll, Gs, Gs, Gs, Rb, Gg, Rb, Gll^Fp, Rd, Rd, Rd, Re, Re, Re, Gs, Re, Gg, Gg, Gg, Rb, Re, Gg, Gs, Gs, Gll, Gs, Gd, Gs, Gd, Gg, Gg, Gll^Fp, Gg, Gg
Gll, Gll, Gll^Fp, Gg, Gll^Fp, Gs^Es, Gs^Es, Gll^Es, Gd^Es, Gs, Gd, Gd, Gll^Fmw, Gll^Fmw, Gg, Gg, Re, Gs, Gd^Efm, Gg, Gg, Gll^Fp, Gg, Gll^Fp, Gll^Fmw, Gg, Gg, Gll^Fp, Gll, Re, Gg, Re, Re, Rb, Gs, Gs, Gs^Efm, Gg^Efm, Gs^Efm, Re, Gg, Gs, Gg^Eff, Gs, Gd, Gll^Fp, Gll^Fp, Gll^Fp, Gll^Fp
Gll, Gll^Fp, Gll^Fmw, Gll^Fp, Gd^Fp, Gs, Gs, Gll, Gll, Gll, Gd, Gd^Fp, Gll^Fms, Gll^Fp, Gll^Fp, Gs, Re, Gg, Gg, Gd^Efm, Gg, Gll^Fp, Gg, Gll^Fmw, Gll^Fmw, Gll^Fmw, Gll^Fmw, Gll^Fp, Gll^Fp, Gll, Gg, Gg, Rb, Rb, Gg, Gs, Re^Efm, Re, Gs, Gs^Efm, Gg, Gg, Gg, Gs^Eff, Gs^Eff, Gg, Gd^Fp, Gll^Fp, Gll^Fp
Gll^Fp, Gll^Fp, Gll^Fmw, Gd^Fp, Gd^Fp, Gd, Gs, Re, Gg, Gg, Gll^Fp, Gll^Fms, Gll^Fp, Gll^Fms, Gll^Fp, Re, Re, Gll^Fp, Gg, Gd, Gll^Fp, Gll^Fp, Hh, Gll^Fp, Gll^Fp, Gs^Fms, Gs^Fms, Gll^Fp, Gll^Fp, Gll, Gg, Gd, Gg, Rb, Gg, Gg, Gg, Gg, Gg^Eff, Gg, Wwg, Gg, Gs^Vl, Gg, Gs^Eff, Gd^Eff, Gd, Gll^Fp, Gll^Fp
Gll^Fp, Gll^Fp, Gll^Fmw, Gd^Fmw, Gll^Fp, Gd, Gd^Es, Gs, Gg, Gll^Fp, Gg, Gll^Fp, Gll, Gll^Fp, Gg, Gs, Gg, Gg, Hh, Gg, Hh, Hh, Hh, Hh^Fp, Gs^Fms, Gs^Fds, Gll^Fds, Gll^Fp, Gll^Fp, Gd, Gg, Gg, Re, Rb, Gd, Gg, Gg, Gg^Eff, Wwg, Wwg, Wwg, Wwg^Bw/, Wwg, Wwg, Wwg, Gs^Eff, Gs, Gll^Fp, Gll^Fp
Gll^Fp, Gll^Fp, Gll^Fp, Gd^Fp, Gd^Fp, Gd^Fp, Gd^Es, Gs, Gs^Es, Gg, Gs, Gll, Gg, Gll, Gs, Gs, Chr, Hh, Mm, Hh, Mm, Mm, Hh, Hh, Gll^Fp, Gs^Fms, Gs^Fds, Gll^Fp, Gll^Fp, Gll^Fp, Gll^Fp, Gg, Gd, Re, Gd, Gd, Gs, Wwg, Wog, Wog, Wog, Wog, Wog^Ewf, Wog, Wwg, Gg^Em, Gs, Gg, Gll^Fp
Gll^Fp, Gll^Fp, Gll^Fp, Gll^Fp, Gll^Fp, Gll^Fp, Gll, Gll^Es, Gd, Gs, Gd^Fp, Gs, Gd, Gll, Gs, Gs, Chr, Chr, Hhd, Mm, Mm, Mm, Hhd, Hh, Gll, Gll, Gs, Gg, Gll^Fp, Gll^Fp, Gll^Fp, Gll^Fp, Gll, Re, Re, Gs, Gd, Wwg, Wwg, Wog, Wog, Wog, Wog, Wwg, Wwg, Wwg, Gs, Gll^Fp, Gll^Fp
Gll^Fp, Gll^Fp, Gll^Fp, Gll^Fp, Gll^Fp, Gll^Fp, Gll^Fp, Gd, Gg, Gs, Gd^Fp, Gg, Gd, Gd, Gg, Gg, Chr, Chr^Dr, Hhd, Mm, Mm, Hhd, Hh, Gs, Gll^Fp, Gll, Gd, Gg, Gll^Fp, Gll^Fp, Gll^Fp, Gll, Gd, Gs, Rb, Gs, Gg, Gd, Gg^Eff, Wwg, Wwg, Wwg, Wwg, Wwg, Gg, Gg, Gs^Eff, Gll^Fp, Gll
Gs, Gll^Fp, Gd, Gs, Gs, Gll^Fp, Gll^Fp, Gg, Gll^Fp, Gd^Fp, Gg, Gg, Gs, Gg, Gg, Chr, Mm, Mm, Mm^Xm, Mm, Mm, Hhd, Hh, Gll^Fp, Gll^Fp, Gg, Gd, Gd, Gll^Fp, Gll^Fp, Gs, Gs, Gg, Gs, Gg, Rb, Rb, Gs, Re, Gg^Eff, Gg, Gg, Gg, Gg, Gg^Eff, Gs^Eff, Gd, Gll^Fp, Gll
Hh, Hh, Hh, Gd, Gll^Fp, Gll^Fp, Gd^Fp, Gd^Fp, Gll^Fp, Gd^Fp, Gd^Fp, Gll, Gll, Gg, Gg, Hh, Mm, Mm, Mm, Mm, Hhd, Hhd^Dr, Hh^Fp, Gll^Fp, Gd^Fp, Gd^Fp, Gll^Fp, Gg, Gs, Gs, Gg, Gg, Gs, Gs, Gg, Gg, Re, Rb, Rb, Gd, Re, Gg, Gll^Fp, Gg, Gll^Fp, Gs, Gll, Gd, Gg
Mm, Hh, Mm, Gd, Gll^Fp, Gll^Fp, Gll^Fp, Gll^Fp, Gll^Fp, Gg, Gg, Gs, Gg, Gll, Hh, Hh, Wog, Wog, Mm, Hhd, Hh^Fp, Hhd^Dr, Hh^Fp, Gll^Fp, Gd^Fp, Gd^Fp, Gg, Gg, Gs, Gs, Gg, Gg, Gs^Fp, Gs, Gs, Gg, Gg, Gs, Gs, Re, Re, Re, Gll^Fp, Gll^Fp, Gll^Fp, Gll, Gll, Gd, Gg
Mm^Xm, Mm, Mm, Gd, Gs, Gll^Fp, Gll, Gg, Gg, Gs, Gg, Gs, Gg, Hh, Wog, Wog, Mm, Mm, Mm, Hhd, Hh^Fp, Hh^Fp, Gll^Fp, Gll^Fp, Gll^Fp, Gll^Fp, Gll^Fp, Gg, Gs, Gg, Gll^Fp, Gll^Fp, Gll^Fp, Gs, Gg, Gs^Vct, Gg, Gg, Ce, Gs, Gg, Re, Gg, Gll^Fp, Gll, Gll^Fp, Gg, Gd, Gg
Mm, Mm^Xm, Mm^Xm, Mm, Mm, Gs, Gs, Gll, Gll, Gs, Gs, Gs, Gg, Hh, Hh, Mm, Mm, Mm, Hh, Hhd, Hh^Fp, Gll^Fp, Gll^Fp, Gll^Fp, Gll^Fp, Gll^Fp, Gll^Fp, Gs, Gs, Gll^Fp, Gll^Fp, Gll^Fp, Gll^Fp, Gll^Fp, Gs, Gg, Gg, Ce, 2 Ke, Ce, Gg, Re, Gg^Vct, Gg, Gs, Gll, Gs, Gd, Gll^Fp
Gs, Mm, Mm^Xm, Mm, Mm, Hh, Hh, Hh, Gll, Gs, Gs, Gg, Gll^Fp, Gg, Gll^Fp, Gd, Gd, Hh, Gll^Fp, Hh^Fp, Hh^Fp, Hh^Fp, Gll, Gll^Fp, Gll^Fp, Gll^Fp, Gll^Fp, Gs, Gs, Gll^Fp, Gll^Fp, Gll^Fp, Gll^Fp, Gg, Gs, Gg, Gg, Ce, Ce, Ce, Gg, Re, Re, Gs, Gs, Gs, Gll^Fp, Gll^Fp, Gll^Fp
Gs, Mm, Mm, Mm^Xm, Mm, Mm, Mm, Hh, Gg, Gs, Gs, Gg, Gd, Gll^Fp, Gll, Gd, Gll^Fp, Gll^Fp, Gll, Gll^Fp, Gll^Fp, Gll, Gd, Gll^Fp, Gll^Fp, Gll^Fp, Gll^Fp, Gs, Gs, Gll^Fp, Gll^Fp, Gll^Fp, Gll^Fp, Gll^Fp, Gd, Gg^Vct, Gd, Gg, Gg, Re, Gg, Gs, Re, Gg, Gs, Gs, Gs, Gll^Fp, Gll^Fp
Gll^Fp, Gs, Mm, Mm^Xm, Mm^Xm, Mm, Mm, Hh, Gg, Gs, Gd, Gs, Gs, Gd, Gd, Gll, Gg, Gll, Gll^Fp, Gll^Fp, Gll^Fp, Gll^Fp, Gll^Fp, Gd^Fp, Gg, Gll^Fp, Gll^Fp, Gs, Gg, Gg, Gll^Fp, Gll^Fp, Gg, Gg, Gg, Gs, Gs, Gd, Gs^Vct, Gg, Gs, Gs, Gs, Re, Gg, Gg, Gg, Gll^Fp, Gll^Fp
Gll^Fp, Gs, Gs, Mm, Mm, Mm^Xm, Mm, Hh, Hh, Gg, Gg, Gg, Gs, Gd, Gd, Gs, Gg, Gll^Fp, Gll^Fp, Gll^Fp, Gll^Fp, Gll^Fp, Gll^Fp, Gd, Gg, Gll^Fp, Gll^Fp, Gll^Fp, Gg, Gg, Gll^Fp, Gll^Fp, Gll^Fp, Gll^Fp, Gll^Fp, Gg, Gs, Gd, Gs, Gs, Gs, Gs, Gs, Re, Gs, Gs, Gll^Fp, Gll^Fp, Gll^Fp
Gll^Fp, Gll^Fp, Gll^Fp, Gs, Mm, Mm^Xm, Mm, Hh, Hh, Gg, Gg, Gs, Gs, Gd, Gs, Gs, Gg, Gg, Gll^Fp, Gll^Fp, Gll^Fp, Gll^Fp, Gg, Gg, Gg, Gg, Gg, Gll^Fp, Gd, Gg, Gg, Gg, Gg, Gs, Gs, Gs, Gg, Gd, Gll^Fp, Gs, Gll^Fp, Gs, Gs, Re, Gg, Gg, Gg, Gll^Fp, Gll^Fp
Gll^Fp, Gll^Fp, Gll^Fp, Gs, Mm, Mm^Xm, Mm^Xm, Mm, Hh, Hh, Gg, Gg, Gg, Gs, Gg, Gg, Gg, Gg, Gll^Fp, Gll^Fp, Gg^Fp, Gll^Fp, Gg^Fp, Gll^Fp, Gg^Fp, Gg, Gg, Gg, Gg, Gd, Gg, Gg, Gg, Gg, Gg, Gg, Re, Gg, Gll^Fp, Gll^Fp, Gll^Fp, Gll^Fp, Gg, Re, Gg, Gg, Gg, Gll^Fp, Gll^Fp
