Hh, Hh, Mm, Hh, Gll^Fp, Gg, Gll^Fp, Gg, Gg, Re, Re, Re, Gg, Hh^Fp, Gll^Fp, Gd, Gg, Gg, Gg, Gll^Fp, Gll^Fp, Gg, Hh, Hh, Mm, Hh, Mm, Mm, Mm, Hhd, Hhd, Hhd, Gs, Gs, Gll^Fdw, Rr, Rr, Rp, Gd^Es, Gg, Gd, Gg, Gg, Gg, Wog, Gll^Fp, Gll^Fp, Gll^Fp, Gll^Fmw
Hh^Fmw, Mm, Mm, Mm, Mm, Hh, Hh, Gll^Fp, Re^Vct, Re, Re, Gg, Gs, Gll^Fp, Gll^Fmw, Gll^Fmw, Gll^Fp, Gg, Gll^Fp, Gll^Fp, Gll^Fmw, Hh^Fp, Gll^Fmw, Hh^Fp, Hh, Mm, Mm, Mm, Mm, Hhd^Fp, Gll^Fmw, Hhd, Gll^Fmw, Gll^Fdw, Gll^Fdw, Re^Edt, Rr^Edt, Gg^Vo, Gs, Gs^Es, Gll^Fmw, Gd, Re, Co, Co, Wog, Gg, Gll^Fp, Gll^Fmw
Hh^Fmw, Hh^Fp, Mm, Mm, Hh^Fp, Hh^Fp, Gg^Ecf, Gg, Rd, Rd, Ce, Gs, Gs, Gg^Fet, Gs^Fms, Gll^Fmw, Gs^Fms, Gll^Fp, Gll^Fp, Gll^Fp, Gll^Fp, Gll^Fmw, Gs, Hh^Fdw, Hh, Hh, Mm, Mm, Hhd, Hhd, Hhd^Fdw, Hhd^Fdw, Hhd, Gll^Fmw, Co, Re, Gs^Es, Re, Re, Gs, Rr, Rp, Gs, Re, Co, Wog, Wog, Gll^Fp, Gll^Fp
Hhd^Fmw, Mm, Mm, Mm, Hh^Fmw, Hh^Fmw, Re, Gs, Re^Es, Ce, 1 Ke, Ce, Re, Gg, Gs, Gs^Fms, Gg, Gll^Fp, Gs^Fms, Gll^Fp, Gg, Gs, Gll^Fp, Hh^Fp, Mm, Mv, Mm, Hhd^Fmw, Gll^Fmw, Gd, Gll, Hhd^Fmw, Gs, Co^Edt, Rp, Gs, Rr, Re, Co, Co, Rr^Edb, Rr^Edb, Rr^Vd, Gd, Gd, Co, Wog, Gs, Gg
Hhd, Hhd, Hhd, Hhd, Hh, Gg, Gs, Re, Re^Es, Ce, Ce, Ce, Re, Gg, Re^Vct, Gs, Gs^Fms, Gll^Fp, Gll^Fmw, Gll^Fp, Gll^Fp, Gg, Hh, Hhd, Hhd, Mm, Md, Hhd^Fp, Hhd, Gs, Gll, Gs^Es, Rr^Vd, Rp, Rr^Es, Rr, Rr, Co, 3 Ko, Co, Co, Rr^Edb, Rr, Gs, Wog, Wog, Gd, Gd, Gg
Hh^Fp, Hhd^Fmw, Gll^Fp, Gg, Gs^Es, Rd^Vct, Gg, Re, Gll^Fp, Re, Re, Gg, Gs^Ecf, Re, Gg, Gg, Gll^Fp, Gs^Fms, Gll^Fp, Gll^Fp, Gg, Gg, Gll^Fp, Gll^Fp, Hhd, Hhd, Wwf^Em, Hhd, Hhd, Co, Gll^Fdw, Gd, Gll^Fdw, Gd, Rp, Rr, Co, Co^Edt, Co, Co, Rr, Rr, Rr, Wog^Bw\, Re, Rb, Rb^Es, Gd, Gg
Re, Hh^Fp, Gll^Fp, Gg, Re, Re, Re, Gg, Gg, Gll^Fp, Re, Gg, Gs, Gs, Gg, Gll^Fp, Re, Gs, Gg, Gs, Gll^Fp, Gg, Gll^Fp, Gd^Fmw, Gd, Wwf^Es, Wwf, Hhd, Gs, Co, Gll^Fdw, Gll^Fdw, Gll^Fdw, Gll^Fdw, Rp, Rr, Rr, Co, Re, Co, Rr, Rr^Es, Rp, Wog, Re, Re^Es, Re, Gd, Gg
Re, Re, Re, Re, Gs, Gs, Re, Re, Rd, Re, Re, Re^Es, Re, Gg, Re, Re, Gg, Gs, Gg, Gg, Gg, Gll^Fp, Gll^Fmw, Gs^Fms, Gs, Gg, Gg, Wwf^Em, Wog, Gs, Gd, Gd, Re^Edt, Re^Es, Rp, Rr, Rr, Rr, Re^Edb, Re, Re^Vo, Rr, Wog, Wog, Co, Gll^Fdw, Gll^Fdw, Re, Re
Gll^Fp, Gll^Fp, Gll^Fmw, Gll^Fp, Gg, Gg, Gll^Fp, Gll^Fp, Gll^Fp, Gg, Gg, Gg, Gg, Re^Es, Gg, Gg, Gg, Gg, Gll^Fp, Gg, Gs^Vh, Gg, Gll^Fp, Gll^Fp, Gll^Fp, Gg, Gg, Gg, Ds, Wog^Bw/, Gd^Vo, Re, Re^Edt, Rr, Gd, Gd, Co, Gd^Edt, Co, Re, Gd, Rr, Wog, Wog, Co, Gll^Fdw, Gll^Fdw, Gll^Fdw, Gg
Gll^Fp, Gll^Fmw, Ds, Ds, Ds, Gg, Ds, Gll^Fp, Re, Gll^Fp, Gg^Efm, Gg, Gg, Re, Re, Gg, Gll^Fp, Gll^Fp, Gll^Fp, Gg, Gg, Gg^Efm, Gg^Efm, Gll^Fp, Gg^Es, Gg, Wwf, Ds, Wog, Wog, Rd, Re, Gll^Fdw, Re, Gll^Fmw, Gs, Gs, Co, Gg^Efm, Gs, Gs, Gg, Wog, Co, Ds, Gg, Gg, Gg, Gg
Gg, Ds, Wo, Wo, Wo, Wo, Wo, Ww, Ww, Ds, Ds, Gg^Efm, Re, Rr, Rr, Gs, Gg, Gll^Fp, Gll^Fp, Gg, Gg, Gg^Efm, Gg^Es, Gg, Gg, Gg, Gg, Wwf, Gs, Rd, Rp, Gg, Gg, Gll^Fmw, Gll^Fp, Gll^Fmw, Gll^Fp, Gg, Gg^Efm, Gg^Efm, Gg, Gg, Gg, Wog, Wog, Ds, Wog, Wog, Wog
Gg, Ds, Ds, Wo, Wo, Wo, Wo^Ewf, Wo, Wo, Ww, Re, Re, Gll^Fp, Gll^Fp, Re^Es, Gg, Gs, Gll^Fp, Gg, Re, Gs, Gg, Gg, Gg^Efm, Gg^Efm, Gg^Efm, Gg, Gg, Re, Re^Es, Rr, Gg, Gll^Fp, Gll^Fp, Gll^Fp, Gll^Fmw, Gll^Fp, Gg^Fp, Gg^Efm, Gg^Efm, Gg^Efm, Gg^Es, Gg, Gg, Re, Wog, Wog, Gg, Gg
Gg, Gg, Ds, Ww, Ww^Bw/, Wo, Wo, Wo, Ww, Ww, Ds, Re, Gs^Fms, Gs^Fds, Gll^Fmw, Re, Gg, Gg, Gg, Re, Re^Es, Gg, Gg, Gg, Gg, Gg, Gg, Gs, Re, Re^Es, Gs, Gll^Fmw, Gll^Fp, Gll^Fmw, Hh^Fp, Gll^Fp, Hh, Gg, Gs, Gs^Es, Gs, Gg, Gll^Fp, Re, Wog, Wog, Gg, Gg, Gg
Gll^Fp, Gll^Fp, Gg, Gg, Ds, Ww, Gll^Fp, Wo, Ww, Ds, Gll^Fp, Gll^Fp, Gs, Gs^Fds, Gll^Fp, Re, Re, Gg, Re, Re, Rr, Re, Re, Gg, Re, Gg, Re, Re, Re, Gg, Hh^Vhh, Gs, Hh, Hh, Hh, Hh, Hh, Hh, Hh^Fp, Hh, Hh^Fp, Gs^Fms, Gll^Fp, Re, Wog, Ds, Gll^Fp, Gll^Fp, Gll
Gll^Fp, Gll^Fp, Gll^Fp, Gg, Gg, Ds, Gd^Fp, Ds, Re, Re^Gvs, Gs^Vh, Gs^Eff, Gg^Eff, Gg, Gg, Gg, Re, Re, Gg, Gs, Gg, Rr, Rr, Re, Re, Re, Re^Es, Re, Hh, Hh, Mm, Hh, Mm, Mm, Mm, Mm, Mm, Mm, Hh, Hh^Fp, Hh^Fp, Gll^Fp, Gg, Re, Wog, Ds, Gll^Fp, Gll^Fp, Gll^Fp
Gll^Fp, Gll^Fp, Gll^Fp, Gg, Gll^Fp, Gd^Fp, Gll^Fmw, Gll^Fmw, Re^Gvs, Re^Gvs, Re^Gvs, Gs^Eff, Gg^Efm, Gg^Efm, Gg, Gs, Gs, Gg, Gg, Gg, Gg, Gg, Gll^Fp, Gg, Gs^Fms, Re, Re, Gs, Gs, Hh, Gll^Fp, Mm, Mm, Mm, Hh, Mm, Hh, Mm, Hh, Hh, Hh^Es, Gg, Wwg, Wog, Ds^Em, Ds, Ds, Hh, Hh
Gll^Fp, Gll^Fp, Gll^Fp, Gll^Fp, Gll^Fp, Gd, Gd, Gs, Re, Re^Gvs, Re, Gg^Efm, Re, Gg^Efm, Gg, Gs, Rp, Re, Gg, Gs^Vh, Gg, Gs^Fms, Gs^Fds, Gs^Fds, Gll^Fp, Re, Re, Gg, Gs, Gll^Fp, Gll^Fp, Re, Hh, Hh, Hh^Fmw, Hh, Gs, Hh, Hh, Hh, Ds, Wwg, Wog, Wog, Wog, Wwg, Hh, Ds, Hh
Gll^Fp, Gll^Fp, Gll, Gs, Gs^Vl, Gs, Re, Gg, Gg^Fms, Gg, Gg, Re, Gg, Re, Gg, Rp, Chr, Re, Re, Gg^Es, Gs, Gg, Gs^Fds, Gs^Fds, Gll^Fp, Gg, Re, Gg^Eff, Gg^Eff, Gg, Re, Re, Gg, Gll^Fmw, Gll^Fmw, Hh^Fmw, Gg, Gs, Gs, Gs, Hh, Ds, Wwg, Wog, Wwg, Wwg, Gll^Fp, Hh, Hh
Gll^Fp, Gll^Fmw, Gs^Fmw, Gs^Es, Gs, Re, Gll^Fp, Gg, Gg^Fms, Gg^Fp, Gs, Gs, Gs, Re, Re, Chr, Gg, Gg, Re, Gg, Chr, Gs, Gs, Gg, Gg, Gg, Gg, Re, Rr, Re, Gg, Gg, Gg^Efm, Gg^Efm, Gg, Re, Gg, Gg, Gg, Gg, Hh^Fp, Ds, Ds, Wwg, Ds, Ds, Gs, Hh^Fp, Gg^Fp
Gll^Fp, Gll^Fp, Gll, Gs^Es, Gd, Gll^Fp, Gll^Fp, Gs^Fms, Gs^Fms, Gg^Fms, Gll^Fp, Gg, Gg, Gg, Gg, Chr, Gg, Gs, Re, Chr, 5 Khr, Ch, Gg, Gs, Gs^Vh, Gg, Gg, Gg, Rr, Gg, Gg, Gg^Efm, Gg, Gg^Efm, Gg, Gg, Gs, Gg, Gll^Fms, Hh, Gll^Fp, Gll^Fp, Gll^Fmw, Gll^Fp, Re, Gs, Gs^Vl, Gll^Fp, Gll^Fp
Gll^Fmw, Gs^Fms, Gs^Fms, Gd^Fmw, Gs^Fms, Gs^Fms, Gll^Fp, Gs^Fms, Gg, Gg^Fp, Gg, Gg, Gg, Gg, Gg, Gg, Re^Es, Gs, Rp, Rp^Edb, Chr^Es, Ch, Gg, Gs, Gg, Gg, Gg, Gg, Re^Es, Re, Re, Gg, Ce, Gg, Gg, Gs, Gg, Gg, Gs^Fms, Gs^Fms, Gll^Fp, Gll^Fmw, Gll^Fmw, Re, Re^Gvs, Re^Gvs, Gg, Gg^Efm, Gg
Gs^Fds, Gs^Fds, Gll^Fp, Gll^Fp, Gll^Fp, Gll^Fp, Gll, Gs^Es, Re, Gg, Re, Rd, Rd, Re, Re, Re, Re, Re, Rp, Gg, Gg, Gg, Gg, Gg, Gg, Gg, Re, Re, Gg, Gg, Gg, Re, Re, Ce, Ce, Gs, Gg, Gg, Gg, Gs^Fms, Gll^Fp, Gll^Fmw, Gll, Re^Gvs, Re^Gvs, Re^Gvs, Gg, Gll^Fp, Gll^Fp
Gd^Fp, Gs^Fds, Gs^Fms, Gll^Fmw, Gg, Gll^Fp, Gs, Gs, Re, Rd, Rd, Rd, Gg, Hh^Fmw, Hh^Fp, Gs, Gll^Fp, Rp, Gg, Rp, Gs, Gs, Chr, Chr, Re, Re, Gg, Gg, Gg, Gg, Gll^Fp, Rd, Rd, Re, Re, Re, Re, Gg, Re, Gg, Gg, Gg, Gg, Re, Gg, Gg, Gg^Efm, Gll^Fp, Gg
Gd^Fp, Gll^Fmw, Gs^Fms, Gg, Gg, Gg, Gs, Re, Gg, Gg, Gg, Gll^Fp, Gg, Gd, Gll^Fp, Gll^Fp, Gg, Gg, Gg, Rp, Re, Gs, Re, Gs, Re, Gg, Gg^Eff, Gg^Eff, Gg^Eff, Gg, Gll^Fp, Gll^Fp, Rd, Gg, Gg, Gg^Efm, Gg, Re, Gg, Re, Rd, Gg, Re, Re, Gg^Eff, Gg, Gg^Efm, Gg, Gg
Gll, Gll^Fmw, Gll^Fp, Gs^Fms, Gll, Gs, Re, Re, Gg, Gg, Gll^Fms, Gll^Fp, Gg, Gs, Gd^Es, Hh^Fp, Hh, Gg, Gg, Re, Re, Re, Hh^Fp, Re, Gll^Fp, Gll^Fp, Wwf, Wwf^Em, Wwf, Gg, Gg, Gll^Fp, Re, Gg, Gg^Efm, Gg^Efm, Gg^Efm, Gg, Gg, Gg, Gg, Rd, Gg, Gg^Eff, Gg, Gg^Efm, Gg, Gg, Gg
Gll^Fp, Gll, Gll, Gg, Gs, Re^Vct, Rd, Gg, Gg, Gg, Gll^Fp, Gll^Fp, Gd, Gs, Gll^Fmw, Hh^Fp, Mm, Hh, Hh, Gg, Gg, Hh^Fp, Gll^Fp, Gll^Fp, Gll^Fp, Ss, Wog, Wog, Ss, Gg, Gg, Re, Re, Gg, Gg, Gg, Gg, Gg, Gll^Fp, Gll^Fmw, Gs^Fms, Gll^Fp, Gll^Fp, Gg, Hh, Gg, Gs, Gg, Gg
Gll^Fp, Gll, Gg^Edt, Gg, Gd^Ecf, Gd, Rd, Gg, Gg, Gs^Vct, Gs, Gg, Gg, Gs, Hh^Fmw, Hh, Ch^Fet, Mm, Hh, Hh, Gs, Gs, Gll^Fp, Ss, Ss, Ss, Ss, Wog, Ss, Gg, Re, Re, Gg, Gg, Gg, Gg, Gll^Fp, Gll^Fmw, Gll^Fmw, Gll^Fp, Gll^Fmw, Hh^Fp, Hh^Fp, Gll^Fp, Hh^Es, Gg, Gs, Gg, Gg
Gll^Fp, Gll^Fp, Gs, Gg, Re, Re^Es, Ce, Re, Re, Re, Re, Gs^Em, Gg, Gll^Fp, Hh^Fp, Hh, Mm, Mm, Mm, Hh, Hh, Gg, Gg, Gs, Gg^Efm, Gs^Efm, Gs, Ss, Gll^Fp, Gg, Re, Rd, Rd, Gg, Gg, Gll^Fp, Gll^Fp, Gll^Fmw, Gll^Fp, Gg, Gg, Hh^Fp, Gg, Hh^Fmw, Hh^Fp, Hh, Gg, Gg, Gg
Gll^Fp, Gll^Fp, Gll^Fp, Gg, Re, Ce, 4 Ke, Ce, Re, Gg, Re^Vct, Gg, Gg, Gg, Hh, Mm, Mm, Mm, Mm, Hh, Gs, Gg, Gg, Gg^Efm, Gg^Efm, Gg, Gll^Fp, Gll^Fp, Gll^Fp, Gll^Fp, Gg, Re, Re, Rd, Re, Re, Re, Re, Re, Re^Vct, Re, Gg, Gs, Gs, Gs, Gg, Gg, Gg, Gg
Gg, Gll^Fp, Gll^Fp, Re, Re, Ce, Ce, Ce, Re, Gs^Ecf, Gg, Re, Gll^Fp, Hh, Mm, Mm, Hh, Hh^Es, Hh, Gs, Gll^Fp, Gg, Gg, Gs^Vc, Gg, Gg, Gg, Gll^Fp, Gg, Gg, Gg, Gg, Gg, Re^Es, Re, Gg, Gs, Gg, Gg^Ecf, Re, Ce, Ce, Ce, Re, Re^Ecf, Gg, Gg, Gd, Gg
Gs, Gll^Fp, Gg, Gg^Vct, Re, Re, Re, Re, Gg, Gg, Gg, Gll^Fp, Gll^Fmw, Gll^Fms, Hh^Fp, Hh, Hh^Fp, Gll^Fp, Hh, Gll^Fp, Gll^Fp, Gll^Fp, Gll^Fp, Re, Re, Gg, Gs, Gs, Gs, Gg, Gg, Gg, Gg^Eff, Re, Re, Re, Gs, Gs, Re, Re, Ce^Es, 2 Ke, Ce, Re, Re, Gg^Vct, Gg, Gd, Gll^Fp
Re, Gg, Rp, Re, Re, Gg, Gg, Gg, Gll, Gll^Fp, Gs^Fms, Gll^Fp, Gll^Fp, Gll^Fmw, Gll^Fp, Gll, Gd, Gd^Fp, Hh^Fp, Gll^Fmw, Gll^Fp, Gll^Fp, Gll^Fp, Gg, Gg, Re, Gll^Fp, Gll^Fp, Gll^Fp, Gll^Fp, Gg, Gg, Gll^Fp, Gg^Eff, Gg^Eff, Re, Re, Re^Vct, Gg, Gs, Re, Ce, Re, Ce, Gg, Gg, Gll^Fp, Gll^Fp, Gll^Fp
Rp, Rp, Gg, Rp, Rp, Gs^Edt, Gd, Gg, Gg, Gs^Fms, Gs^Fms, Gs^Fms, Gll^Fmw, Gll^Fmw, Gll^Fp, Gs, Gll^Fp, Hh^Fp, Hh, Hh, Hh, Gll^Fmw, Re, Re, Re, Re, Gll^Fp, Gll^Fp, Gll^Fp, Gll^Fp, Gll^Fms, Gll^Fms, Gll^Fp, Gll^Fp, Gg, Gg, Rd, Gg, Gg, Gs, Gg^Ecf, Re, Re, Gg, Gd, Gs, Gs, Gd^Fp, Gll^Fmw
Gg, Gg, Gll^Fp, Gg, Gll^Fp, Gs^Es, Gs, Gg^Es, Gg^Es, Gs, Gs, Gd, Gs, Gg, Gll^Fp, Gll^Fp, Gs^Fms, Hh^Fp, Gll^Fp, Gll^Fp, Gll^Fp, Gll^Fp, Gll^Fp, Gs, Re, Gg, Gs, Gs, Ds, Gg, Gg, Gll^Fp, Gll^Fmw, Gll^Fmw, Chr, Gg, Gs, Rd, Rd, Gg, Re, Re, Gg, Gg^Vct, Gg, Gd, Gd, Gd^Fmw, Gll^Fmw
Gll, Gll^Fp, Gll^Fp, Gs^Fms, Gd^Fp, Gs, Gg, Gg, Gll, Gs, Gg, Gg, Gll^Fmw, Gg, Gs^Fms, Gs^Fms, Gd^Fms, Gd^Fms, Gs, Gll^Em, Gll, Gll^Fp, Gll^Fp, Gd, Gll, Gg, Gg, Gg, Ds, Gs, Gg, Gll^Fp, Gs, Gll^Fp, Chr, Gg, Gg, Gs, Gg^Efm, Re, Re, Gg, Gg, Gg, Gs, Gs, Gll^Fp, Gll^Fmw, Gll^Fmw
Gll^Fp, Gs^Fds, Gs^Fds, Gs^Fms, Gs^Fms, Gg, Gd^Vhr, Re, Gg, Gs, Gll^Fp, Gll^Fms, Gll^Fp, Gll^Fms, Gs^Fms, Gll^Fp, Gs^Fds, Gd^Fms, Gll^Fp, Gg, Gll^Fp, Gll^Fp, Gg, Gs, Gg, Gg, Gg, Gg, Ds, Ds, Ds, Gg, Gs, Chr, Gg, Gg, Gg, Gg^Efm, Gg^Efm, Gg, Re, Gg, Gg^Eff, Gg, Gg, Gg, Gg, Gll^Fp, Gll^Fp
Gll^Fp, Gs^Fds, Gll^Fp, Gll^Fp, Gll^Fp, Gd, Gg, Gs, Gg, Gll^Fp, Gg, Gll^Fp, Gll, Gll^Fp, Gs^Fms, Gs^Fds, Gs^Fds, Gs^Fds, Gll^Fp, Gll^Fp, Gg^Fp, Gg, Gg^Fp, Gll^Fp, Gg^Fp, Gg, Gg, Ds, Ds, Ds, Gg, Gg, Gg, Gg, Gg, Gg, Gg, Gg^Efm, Gg^Efm, Gg, Re, Re, Rd, Gg^Eff, Gg, Gg, Gg, Gll^Fp, Gll^Fp
