border_size=1
usage=map

Xu, Xuc, Xu, Xu, Xu, Qxu, Xu, Xu, Xu, Qxu, Xu, Uu, Uu, Ur, Rb, Uu, Xu, Xu, Xu, Xu, Wog, Wog, Wwg, Wwf, Uh, Uu^Vud, Rb^Uf, Rr, Rb^Em, Rb^Uf, Xu, Xu
Xu, Xu, Xu, Xu, Xu, Xu, Uu, Uu, Uh, Xu, Uh, Uh, Urb, Uu, Re, Urb, Uu^Uf, Xue, Uu, Wwg, Wwg, Wwg, Wwg, Xu, Xu, Uu^Uf, Rb^Uf, Rr, Rb, Rb^Uf, Uh, Uh
Xu, Xu, Xu, Xu, Xu, Uu, Uu, Xu, Uh, Uu^Uf, Uu^Vu, Urb, Re, Re, Uu, Uu, Xu, Xu, Wwg, Wwg, Wwg, Wwg, Xue, Xu, Xu, Uu^Uf, Uu^Uf, Uu, Rb^Uf, Re^Uf, Uu^Vud, Xu
Xu, Xu, Xu, Xu, Uu, Uu, Qxu, Xu, Uu^Uf, Uu^Uf, Uu, Uu, Re^Em, Uu, Uh, Qxu, Qxu, Xue, Xue, Wwg, Wwg, Wwg, Xue, Xu, Uu^Uf, Uh, Rr, Rb, Rb^Uf, Uu^Uf, Xu, Xu
Xu, Xu, Xu, Uu, Urb, Uu, Xu, Qxu, Uu, Uu, Uue, Re, Uue, Uue, Uh, Qxu, Qxu, Qxu, Wwg, Wwg, Wwg, Xue, Xu, Xu, Uu^Uf, Rb^Uf, Rb^Em, Rb, Uh, Rb^Uf, Uu^Uf, Xu
Xu, Xu, Xu, Uu, Uu, Uu, Xu, Qxu, Qxu, Uu, Re^Es, Uue, Uue, Uue^Uf, Uue^Uf, Uh, Qxu, Uu, Uu, Wwg, Xue, Xue, Xu, Xu, Rb^Ngl\, Rr, Rr, Uh, Xu, Uu^Uf, Xu, Xu
Wog, Xu, Xu, Xu, Xu, Xu, Xu, Qxu, Qxe, Uue^Uf, Re, Re, Uue, Uu, Cud, Uu^Uf, Uu^Uf, Uu, Rb, Wwg, Xu, Xu, Uu^Uf, Uu^Vu, Rb, Xu, Xu, Xu, Xu, Xu, Uh, Xu
Wog, Wog, Wog, Xu, Xu, Xu, Xu, Uu, Cud, Re, Uue, Uue, Uue, Kud, Cud, Xu, Xu, Uu, Rb, Uu^Vu, Xu, Xu, Rb^Uf, Rb, Rb^Em, Xu, Xu, Xu, Xu, Uh, Urb, Uh
Wog, Wog, Wog^Xo, Xu, Xu, Qxu, Qxu, Uu, Cud, Qxu, Uh, Re, Re, Uue, Uh, Qxu, Qxu, Uh, Uu, Uu, Xu, Re^Uf, Rb^Uf, Rb, Uu, Uu^Uf, Cud, Xu, Urb, Urb, Xu, Uh
Xu, Wog, Xu, Wog, Wwg, Xu, Qxu, Qxu, Qxu, Uu^Uf, Qxu, Uu, Uu, Re^Uf, Wwf, Uh, Uh, Uh, Uu, Uu, Uu, Re^Uf, Uu, Rr, Uh, Uu^Uf, Uh^Em, 2 Kud, Cud, Xu, Xu, Xu
Xu, Xu, Uue^Uf, Uue, Re^Em, Wwg, Uu, Uu, Uu, Qxu, Qxu, Qxu, Rb, Uu, Wwf, Uue^Em, Uue, Uue, Rb^Es, Rb, Uu, Uu, Re, Uu, Re, Uh, Rd, Uu, Uue, Xu, Uu, Xu
Xu, Xu, Uh^Uf, Uu, Xu, Xu, Qxu, Uu, Uu, Uu, Uu, Rb, Uu, Uu, Re^Em, Uue, Re, Re, Uu, Rb, Uu, Re, Uue, Rd^Uf, Re^Es, Rd^Es, Urb, Uue, Uue, Rb^Es, Uu, Xu
Xu, Uh, Re^Es, Uue, Xu, Qxu, Qxu, Xu, Xu, Uu, Qxu, Rb, Uue^Xo, Uue, Qxu, Re, Re, Uu, Xu, Xu, Xu, Uue, Uue, Uue, Re, Urb, Urb, Uue, Uue, Rb, Xu, Xu
Xu, Uh, Uu^Vud, Xu, Xu, Xu, Xu, Xu, Cud, Qxu, Qxu, Uu^Xo, Uu, Uu^Xo, Qxu, Qxu, Qxu, Uu^Dr, Uu, Xu, Xu, Uu, Uue, Rb, Re^Es, Uu, Uu^Uf, Uu, Uh, Uu^Uf, Xu, Xu
Xu, Xu, Xu, Xu, Xu, Xu, Xu, 3 Kud, Cud, Qxu, Uh, Uu, Uu, Uu, Xu, Qxu, Qxu, Xu, Uu, Xu, Uu, Xu, Uu, Uue, Re^Emf, Uu^Uf, Uh^Uf, Uh^Uf, Uh, Uh^Uf, Xu, Xu
Xu, Xu, Xu, Xu, Xu, Xu, Xu, Cud, Uu^Uf, Uu^Emf, Uu^Em, Uu^Uf, Rb, Uu, Ur, Xu, Xu, Qxu, Qxu, Uu, Xu, Uu, Xu, Xu, Qxu, Uu^Uf, Qxu, Uh, Uu^Uf, Xu, Xu, Xu
Xu, Xu, Xu, Xu, Qxu, Qxu, Qxu, Xu, Uh, Uh, Uu, Uu, Ur, Uu, Rb, Xu, Xu, Qxu, Qxu, Xu, Xu, Xu, Xu, Xu, Xu, Qxu, Qxu, Qxu, Qxu, Xu, Xu, Xu
Xu, Xu, Qxu, Xu, Qxu, Qxu, Uh, Qxu, Uu^Uf, Uu^Vud, Uu^Em, Rb, Ur, Uu^Uf, Xu, Xu, Xu, Xu, Rb, Xu, Xu, Xu, Xu, Xu, Xu, Qxu, Qxu, Qxu, Qxu, Qxu, Xu, Xu
Xu, Qxu, Qxe, Cud, Qxu, Qxu, Uh, Uh, Uu^Uf, Uu^Uf, Uu, Rb, Rb, Uu, Xu, Xu, Xu, Uue, Xu, Rb, Uu, Xu, Xu, Xu, Xu, Qxu, Qxu, Qxu, Qxu, Qxu, Xu, Xu
Xu, Qxu, Qxu, Qxe, Qxu, Qxu, Qxu, Cud, Xu, Xu, Uu, Uu^Uf, Uu, Xu, Xu, Xu, Qxu, Qxu, Qxu, Qxu, Qxu, Xu, Xu, Xu, Xu, Xu, Xu, Xu, Xu, Xu, Xu, Xu
Xu, Qxu, Qxu, Qxu, Qxu, Qxu, Qxu, Xu, Xu, Xu, Xu, Ur, Uu, Ur, Uu, Uu, Uu, Qxu, Qxu, Qxu, Xu, Xu, Xu, Xu, Xu, Xu, Xu, Xu, Xu, Xu, Xu, Xu
Xu, Xu, Xu, Qxu, Xu, Qxu, Xu, Xu, Xu, Xu, Xu, Uh, Uh, Rb, Uu, Re^Uf, Ur, Rd, Ur^Uf, Uh^Uf, Uh^Uf, Xu, Qxu, Xu, Xu, Xu, Xu, Xu, Xu, Xu, Xu, Xu
Xu, Xu, Xu, Xu, Xu, Xu, Xu, Xu, Xu, Xu, Xu, Xu, Uu^Vu, Ur, Qxu, Uu, Uu, Re, Uu, Rb, Uh, Uh, Qxu, Qxu, Qxu, Xu, Xu, Xu, Xu, Xu, Xu, Xu
Xu, Xu, Xu, Xu, Xu, Xu, Xu, Xu, Xu, Xu, Xu, Xu, Qxu, Qxu, Qxu, Qxu, Uu, Uu, Qxu, Qxu, Qxu, Qxu, Qxu, Qxu, Qxu, Xu, Xu, Xu, Xu, Xu, Xu, Xu
Wog, Wog, Wog, Wog, Wog, Xu, Wog, Xu, Xu, Xu, Xu, Qxu, Qxu, Qxu, Qxu, Qxu, Qxu^Bcx/, Uu, Qxu^Bcx\, Qxu, Qxu, Qxu, Qxu, Qxu, Qxu, Xu, Xu, Xu, Xu, Xu, Xu, Xu
Wog, Wog, Wog, Wog, Wog, Wog, Wog, Wog, Wog, Xu, Xu, Qxu, Qxu, Qxu, Uue, Qxu^Bcx/, Qxu, Qxu, Qxu, Qxu^Bcx\, Uue, Uue, Xu, Qxu, Xu, Xu, Xu, Xu, Xu, Xu, Xu, Xu
Wog, Wog, Wog, Wog, Wog, Wog, Wog, Wog, Wog, Xu, Xu, Xu, Xu, Re^Uf, Re, Uue, Re, Qxu, Qxu, Qxu, Uue, Uue, Xu, Xu, Xu, Xu, Xu, Xu, Xu, Xu, Xu, Xu
Xu, Wog, Xu, Wog, Wog, Wog, Wog, Wog, Wog^Xo, Wog^Xo, Wog, Xu, Xu, Uue^Uf, Uue^Uf, Re^Es, Uu, Cud, Kud, Cud, Re, Uue, Re, Uu^Vud, Uh, Xu, Xu, Xu, Xu, Xu, Xu, Xu
Xu, Xu, Xu, Xu, Xu, Xu, Xu, Xu, Xu, Wog, Wog, Wwg, Xu, Xu, Uu^Vu, Re, Uu, Uu, Rb^Es, Uue, Uue, Re^Es, Re, Uu, Uh, Xu, Xu, Xu, Xu, Xu, Xu, Xu
Xu, Xu, Xu, Xu, Xu, Xu, Xu, Xu, Xu, Wwg^Em, Wwg, Wog, Wog, Xu, Uu, Re, Re, Rb, Uue, Uue^Uf, Uue^Uf, Uue^Uf, Uu^Uf, Uu^Uf, Uh^Uf, Xu, Xu, Xu, Xu, Xu, Xu, Xu
Xu, Xu, Uh^Uf, Xu, Xu, Xu, Uh, Re, Re, Uu, Uu, Wwg, Wwg^Bw/r, Wog^Bw/, Wog^Bw/r, Uu, Xu, Uu, Uu^Vu, Uu^Uf, Uu, Uue, Uh^Uf, Uu^Uf, Uh^Uf, Xu, Xu, Xu, Xu, Xu, Xu, Xu
Xu, Uh^Uf, Uu^Uf, Uu^Uf, Uue, Uh, Uue, Re, Uue, Uue, Uue, Uu, Rb, Wwg^Bw/, Wog, Wog, Xu, Xu, Xu, Xu, Xu, Uh^Uf, Xu, Uh, Xu, Xu, Xu, Xu, Xu, Xu, Xu, Xu
Uu, Rb^Uf, Rb, Uu^Uf, Uue, Uue, Uue, Uue, Re, Re, Uue, Uue, Rb, Wwg^Es, Wwg, Wog, Wog, Xu, Qxu, Xu, Xu, Xu, Xu, Xu, Xu, Xu, Xu, Xu, Xu, Xu, Xu, Xu
Ur, Rb, 1 Uue, Uue, Re, Re, Uue, Re^Es, Uu, Uu, Uh^Uf, Uh^Uf, Qxu, Qxu, Qxu, Wog, Qxe, Qxu, Qxu, Qxu, Qxu, Qxu, Qxu, Xu, Xu, Xu, Xu, Xu, Xu, Xu, Xu, Xu
Ur, Uue, Uu, Re, Uu, Uu, Uu, Uue, Uu, Uu, Uu, Uu^Uf, Qxe, Qxu, Qxe, Qxu, Qxu, Qxu, Qxu, Qxu, Qxu, Qxu, Xu, Xu, Xu, Xu, Xu, Xu, Xu, Xu, Xu, Xu
Uu, Uu, Uu, Uh, Uh, Uh, Uu, Uu, Uu, Uu, Xu, Xu, Xu, Qxu, Qxu, Qxu, Xu, Xu, Xu, Qxu, Qxu, Qxu, Xu, Xu, Xu, Xu, Xu, Xu, Xu, Xu, Xu, Xu
