border_size=1
usage=map

Xu, Xu, Xu, Xu, Xu, Xu, Xu, Xu, Xu, Xu, Xu, Xu, Xu, Xu, Wwg, Wog, Wog, Xu, Xu, Xu, Xu, Xu, Xu, Xu, Xu, Wwg, Xu, Uh, Uu^Uf, Uh, Xu, Uh, Xu, Xu, Xu, Xu, Xu, Xu
Xu, Xu, Xu, Xu, Xu, Xu, Xu, Xu, Xu, Xu, Xu, Xu, Xu, Xu, Wwg, Wog, Wog, Wog, Wog, Xu, Xu, Xu, Xu, Xu, Wwg, Wwg, Xu, Cud, Re^Em, Uh, Xu, Xu, Uu^Vu, Xu, Xu, Xu, Xu, Xu
Xu, Xu, Xu, Xu, Xu, Xu, Xu, Xu, Xu, Xu, Xu, Xu, Xu, Xu, Uu, Wwg, Wwg, Wog, Wog, Xu, Xu, Xu, Xu, Wwg, Uu, Uu^Vud, Uu^Em, Xu, Rr, Rr, Cud, Urb, Uu^Em, Uh, Uh, Xu, Xu, Xu
Xu, Xu, Xu, Xu, Xu, Xu, Xu, Xu, Xu, Xu, Xu, Xu, Uu, Uh, Uu, Uh, Wwg, Wog, Wog, Wog, Wog, Xu, Xu, Wwg, Wwg, Uh, Uh, Rr, Urb, Cud, Kud, Cud, Xu, Qxu, Qxu, Xu, Xu, Xu
Xu, Xu, Xu, Xu, Xu, Xu, Xu, Xu, Qxu, Qxu, Qxu, Qxu, Uu, Uu, Xu, Xu, Xu, Wwg, Wwg, Wog, Wog, Xu, Xu, Xu, Wwg, Urb, Uu^Em, Urb, Uu^Ii, Cud, Cud, Xu, Wog, Qxu, Qxu, Xu, Qxu, Xu
Xu, Xu, Xu, Xu, Xu, Qxu, Qxu, Uu, Qxu, Qxu, Uh, Uu, Uu, Uh, Xu, Xu, Xu, Xu, Xu, Wwg, Wwg, Wog, Wwg, Wwf, Uu^Uf, Uh, Xu, Urb, Rr, Uu^Uf, Xu, Xu, Xu, Uh^Uf, Uh^Uf, Qxu, Qxu, Qxu
Xu, Xu, Xu, Xu, Xu, Qxu, Qxu, Qxu, Qxu, Qxu, Qxu, Uh, Uu, Xu, Xu, Xu, Xu, Xu, Xu, Xu, Wwf, Wwg, Wwg, Wwf, Ur, Uu^Uf, Xu, Uu^Uf, Rd, Xu, Wwg^Es, Wog, Xu, Xu, Uh, Xu, Xu, Qxu
Xu, Xu, Xu, Xu, Xu, Xu, Qxu, Qxu, Xu, Xu, Xu, Qxu, Xu, Uu, Uu, Ur, Rb, Cud, Xu, Xu, Ur, Wwf, Wog, Wog, Wwg, Xu, Xu, Cud, Uh, Uu, Wwf, Wwg, Xu, Xu, Uh, Xu, Xu, Xu
Xu, Xuc, Xu, Xu, Xu, Xu, Kud, Cud, Cud, Xu, Uh^Uf, Xu, Uh, Uh, Urb, Uu, Re, Urb, Uh^Uf, Uh, Ur, Wwg, Wwg, Wog, Wog, Xu, Qxu, Xu, Xu, Wwf^Es, Qxu, Qxu, Uu, Uh, Uh, Xu, Xu, Xu
Xu, Xu, Xu, Xu, Xu, Xu, Cud, Cud, Cud, Uu, Uh, Uu^Uf, Uu^Vu, Urb, Re, Re^Edb, Uu, Uu, Uu, Uu, Wwf, Wwg, Wog, Wog, Xu, Xu, Qxu, Qxu, Qxu, Qxu, Qxu, Uu, Xu, Uu, Xu, Xu, Xu, Xu
Xu, Xu, Xu, Xu, Xu, Uu, Xu, Xu, Uu, Rr, Rr, Uu^Uf, Uu, Uu, Re^Em, Uu, Uh, Qxu, Qxu, Uu, Uu, Wwg^Es, Qxu, Xu, Xu, Qxu, Qxu, Qxu, Qxu, Qxu, Uu, Uu, Xu, Xu, Xu, Xu, Xu, Xu
Xu, Xu, Xu, Xu, Uu, Uu, Qxu, Xu, Uu^Uf, Uu, Uu, Uu, Uue^Ii, Re^Ii, Uue, Uu, Uh, Qxu, Qxu, Wwf^Uf, Wwg, Wwf, Uh, Qxu, Qxu, Qxu, Uu^Vu, Qxu, Uu, Uu, Cud, Xu, Xu, Xu, Xu, Xu, Xu, Xu
Xu, Xu, Xu, Uu, Urb^Ii, Uu, Xu, Qxu, Xu, Wwf, Qxu, Uu, Re^Es, Uue^Ii, Uue, Uue, Uue, Uh, Ur, Wwf^Uf, Wwg, Uh, Uh, Uh, Uu, Uu, Uu, Uu, Ur, Uu, Uu, Cud, 2 Kud^Edb, Xu, Xu, Xu, Xu, Xu
Xu, Xu, Xu, Uu, Uu, Uu, Xu, Qxu, Qxu, Qxu, Xu, Uue^Uf, Re, Re^Es, Uue, Uu, Cud, Uu^Uf, Uu^Uf, Ur, Ur, Uu, Uu, Uu, Ur, Ur, Ur, Ur, Uh, Ur, Uu, Cud, Cud, Xu, Xu, Xu, Xu, Xu
Xu, Xu, Xu, Xu, Xu, Xu, Xu, Qxu, Qxe, Xu, Uu, Re, Uue, Uue, Uu, Uh, Qxu, Xu, Qxu, Uu, Uh, Uu, Uu, Ur, Wwf^Es, Uu, Uh, Uh, Xu, Cud, Cud, Cud, Xu, Xu, Xu, Xu, Xu, Xu
Xu, Xu, Wwg, Xu, Xu, Xu, Xu, Uu, Cud, Re, Uue, Uu, Uu, Uu, Uu, Uu^Vud, Qxu, Qxu, Qxu, Qxu, Cud, Uu^Uf, Uh, Rb, Uu, Uu, Uh, Xu, Xu, Xu, Xu, Xu, Xu, Xu, Xu, Xu, Xu, Xu
Xu, Wog, Wwg^Xo, Xu, Xu, Qxu, Qxu, Uu, Cud, Qxu, Uh, Re, Uu, Ur, Uu, Uu, Uh, Qxu, Uh^Uf, Uh^Uf, Uh^Uf, Uh^Emf, Ur, Ur, Uh, Uu^Uf, Uh^Em, Xu, Xu, Xu, Xu, Xu, Xu, Xu, Xu, Xu, Xu, Xu
Xu, Wwg, Xu, Wwg, Wwf, Xu, Qxu, Qxu, Qxu, Uu^Uf, Qxu, Uu, Uu, Ur, Uu, Urb, Uue^Em, Uh, Uh, Rb^Uf, Uue, Uh, Re, Uue, Re, Uh, Rd, Uu, Uu, Qxu, Qxu, Qxu, Qxu, Qxu, Qxu, Xu, Xu, Xu
Xu, Xu, Uue^Uf, Uue, Re^Em, Wwf, Uu, Uu, Uu, Qxu, Qxu, Qxu, Uu, Rr, Uu^Ii, Urb^Ii, Uue, Uue, Uu, Rb, Ur, Re, Uue, Rd^Uf, Re^Es, Rd^Es, Urb, Uue, Uue, Uu, Cud, Qxu, Qxu, Qxu, Qxu, Xu, Xu, Xu
Xu, Xu, Uh^Uf, Uu, Xu, Xu, Qxu, Uu, Uu, Uu, Uu, Rr, Uu, Uu, Re^Ii, Re^Ii, Re, Re, Uue, Ur, Uue, Uue, Uue, Uue^Ii, Re^Ii, Urb, Urb, Uue, Uue, Rb^Es, Qxu, Qxu, Qxu, Qxu, Qxu, Qxu, Xu, Xu
Xu, Uh, Re^Es, Uue, Xu, Qxu, Qxu, Xu, Xu, Uu, Qxu, Rr, Uue^Xo, Re, Qxu, Qxu, Uu^Vu, Re, Uu, Uue, Uu, Uu, Uu, Rb^Ii, Re^Es, Uu, Uu^Uf, Uu, Uu, Rb^Vu, Qxu, Qxu, Uh, Qxu, Xu, Xu, Xu, Xu
Xu, Uh, Uu^Vud, Xu, Xu, Xu, Xu, Xu, Cud, Qxu, Qxu, Uu^Xo, Uu, Re^Xo, Qxu, Qxu, Qxu, Uh^Dr, Uh, Uu, Xu, Wwf, Wwf^Em, Uue, Uh^Es, Uu, Uu^Uf, Uu, Uh, Qxu, Qxu, Uh, Urb, Cud, Uh^Uf, Xu, Xu, Xu
Xu, Xu, Xu, Xu, Xu, Xu, Xu, 3 Kud, Cud, Qxu, Uh^Uf, Uu, Uu, Rb, Xu, Qxu, Qxu, Xu, Uh, Xu, Uu, Xu, Wwf, Uh, Uh^Emf, Uh^Uf, Uh^Uf, Uu, Xu, Xu, Xu, Qxu, Urb, Uh^Uf, Uh, Xu, Xu, Xu
Xu, Xu, Xu, Xu, Xu, Xu, Xu, Cud, Uu, Rr, Rb, Uu, Rb, Uu, Uh^Uf, Xu, Xu, Xu, Xu, Uh, Xu, Uu, Uh, Xu, Qxu, Uh^Uf, Qxu, Uh, Xu, Uh, Urb, Uh^Uf, Uu, Xu, Urb, Cud^Bzn, Xu, Xu
Xu, Xu, Xu, Xu, Qxu, Qxu, Qxu, Xu, Uh^Uf, Uu, Uu, Uu, Rr, Uu, Uh^Uf, Xu, Xu, Xu, Xu, Xu, Xu, Xu, Uh, Xu, Xu, Qxu, Qxu, Qxu, Uh^Ii, Urb, Uu^Bzn, Uu, Cud, Urb, Cud, Xu, Xu, Xu
Xu, Xu, Qxu, Xu, Qxu, Qxu, Uh, Qxu, Wwf, Uu^Vud, Uu, Rb, Rr, Uu^Uf, Xu, Xu, Xu, Xu, Uh^Uf, Xu, Uh, Uh, Xu, Xu, Xu, Qxu, Qxu, Qxu, Qxu, Qxu, Xu, Xu, Xu, Xu, Xu, Xu, Xu, Xu
Xu, Qxu, Qxe, Cud, Qxu, Qxu, Uh, Uh^Uf, Xu, Wwf^Em, Xu, Uu, Uu, Uu, Xu, Xu, Xu, Uh^Uf, Xu, Uh, Uh, Xu, Xu, Xu, Xu, Cud, Qxu, Qxu, Qxu, Uh, Xu, Xu, Xu, Xu, Xu, Xu, Xu, Xu
Xu, Qxu, Qxu, Qxe, Qxu, Qxu, Qxu, Cud, Xu, Xu, Xu, Uu^Uf, Ur^Es, Uu, Uu, Xu, Qxu, Qxu, Qxu, Xu, Qxu, Xu, Xu, Xu, Xu, Xu, Xu, Xu, Xu, Xu, Xu, Xu, Xu, Xu, Xu, Xu, Xu, Xu
Xu, Qxu, Qxu, Qxu, Qxu, Qxu, Qxu, Uh^Uf, Uh^Uf, Uh, Uu, Ur, Uu, Uu, Uu, Xu, Qxu, Qxu, Qxu, Qxu, Xu, Xu, Xu, Xu, Xu, Xu, Xu, Xu, Xu, Xu, Xu, Xu, Xu, Xu, Xu, Xu, Xu, Xu
Xu, Xu, Qxu, Qxu, Xu, Xu, Xu, Xu, Xu, Uh, Xu, Uh, Xu, Rb, Uu, Re^Uf, Uu^Ii, Uh^Ii, Uu^Uf, Uh^Uf, Uh^Uf, Xu, Xu, Xu, Xu, Xu, Xu, Xu, Xu, Xu, Xu, Xu, Xu, Xu, Xu, Xu, Xu, Xu
Xu, Xu, Xu, Qxu, Xu, Xu, Xu, Xu, Xu, Xu, Xu, Xu, Uu^Vu, Ur, Ur, Uu, Uu, Uh^Ii, Uu, Uh, Uh, Uh, Qxu, Qxu, Qxu, Xu, Xu, Xu, Xu, Xu, Xu, Xu, Xu, Xu, Xu, Xu, Xu, Xu
Xu, Xu, Xu, Xu, Xu, Xu, Xu, Xu, Xu, Xu, Xu, Xu, Qxu, Uu, Uu, Qxu, Qxu, Uu, Qxu, Qxu, Qxu, Qxu, Qxu, Qxu, Qxu, Qxu, Xu, Xu, Xu, Xu, Xu, Xu, Xu, Xu, Xu, Xu, Xu, Xu
Wog, Wog, Wog, Xu, Xu, Xu, Xu, Xu, Xu, Xu, Qxu, Qxu, Qxu, Qxu, Qxu^Bp|, Qxu, Qxu, Uu, Qxu^Bcx\, Qxu, Qxu, Qxu, Qxu, Qxu, Qxu, Qxu, Xu, Xu, Xu, Xu, Xu, Xu, Xu, Xu, Xu, Xu, Xu, Xu
Wog, Wog, Xu, Xu, Xu, Xu, Xu, Xu, Xu, Xu, Qxu, Qxu, Qxu, Qxu, Qxu^Bcx|, Qxu, Qxu, Qxu, Qxu, Qxu^Bcx\, Uue, Uue, Xu, Qxu, Xu, Xu, Xu, Xu, Xu, Xu, Xu, Xu, Xu, Xu, Xu, Xu, Xu, Xu
Wog, Wog, Wog, Wog, Wog, Wog, Wog, Xu, Wog, Xu, Xu, Xu, Xu, Re^Uf, Re, Qxu, Re, Qxu, Qxu, Qxu, Uue, Uue, Xu, Xu, Xu, Xu, Xu, Xu, Xu, Xu, Xu, Xu, Xu, Xu, Xu, Xu, Xu, Xu
Xu, Wog, Xu, Wog, Wog, Wog, Wog, Wog^Xo, Wog, Wog, Wog, Xu, Xu, Uue^Uf, Uue^Uf, Re^Es, Uu, Cud, Kud, Cud, Re, Uue, Re, Uu^Vud, Uh, Uh, Xu, Xu, Xu, Xu, Xu, Xu, Xu, Xu, Xu, Xu, Xu, Xu
Xu, Xu, Xu, Xu, Xu, Xu, Xu, Xu, Xu, Wog, Wog, Wwg, Xu, Xu, Uu^Vu, Uu, Uu, Cud, Rb^Es, Cud, Uue, Re^Es, Re, Uu, Uh, Uh, Uh, Xu, Xu, Xu, Xu, Xu, Xu, Xu, Xu, Xu, Xu, Xu
Xu, Xu, Xu, Xu, Xu, Xu, Xu, Xu, Xu, Wwg^Em, Wwg, Wog, Wog, Xu, Rb, Rb, Uu, Rb, Uue, Uue^Uf, Uue^Uf, Uue^Uf, Uu^Uf, Uu^Uf, Uh^Uf, Uh, Xu, Xu, Xu, Xu, Xu, Xu, Xu, Xu, Xu, Xu, Xu, Xu
Xu, Xu, Uh^Uf, Xu, Xu, Xu, Uhe^Uf, Uhe^Uf, Uue^Uf, Uu, Uu, Wwg, Wwg^Bw/r, Wog^Bw/, Wog^Bw/r, Rr, Xu, Uu, Uu^Vu, Uu^Uf, Uu, Uue, Uh^Uf, Uu^Uf, Uh^Uf, Uh, Xu, Xu, Xu, Xu, Xu, Xu, Xu, Xu, Xu, Xu, Xu, Xu
Xu, Uh^Uf, Uu^Uf, Uu^Uf, Uu, Uh, Uue, Uhe^Uf, Uue, Uue, Rr, Uu, Uu, Wwg^Bw/, Wog^Ii, Wog^Ii, Xu, Xu, Xu, Xu, Xu, Uh^Uf, Xu, Uh, Xu, Xu, Xu, Xu, Xu, Xu, Xu, Xu, Xu, Xu, Xu, Xu, Xu, Xu
Uu, Rb^Uf, Rr, Uu^Uf, Uue, Uu, Uue, Uue, Re, Rr, Uue, Rr, Rb, Wwg^Es, Wwg, Wog^Ii, Wog, Xu, Qxu, Xu, Xu, Xu, Xu, Xu, Xu, Xu, Xu, Xu, Xu, Xu, Xu, Xu, Xu, Xu, Xu, Xu, Xu, Xu
Ur, Rb, Uue, Uue, Re, Re, Uue, 1 Re^Es, Uu, Uu, Uh^Uf, Uh^Uf, Qxu, Qxu, Qxu, Wog, Qxe, Qxu, Qxu, Qxu, Qxu, Qxu, Qxu, Xu, Xu, Xu, Xu, Xu, Xu, Xu, Xu, Xu, Xu, Xu, Xu, Xu, Xu, Xu
Ur^Ii, Uue^Ii, Uu, Re, Uu, Uu, Uu, Uue, Uu, Uu, Uu, Uu^Uf, Qxe, Qxu, Qxe, Qxu, Qxu, Qxu, Qxu, Qxu, Qxu, Qxu, Xu, Xu, Xu, Xu, Xu, Xu, Xu, Xu, Xu, Xu, Xu, Xu, Xu, Xu, Xu, Xu
Uu, Uu^Ii, Uu, Uh, Uh, Uh, Uu, Uu, Uu, Uu, Xu, Xu, Xu, Qxu, Qxu, Qxu, Xu, Xu, Xu, Qxu, Qxu, Qxu, Xu, Xu, Xu, Xu, Xu, Xu, Xu, Xu, Xu, Xu, Xu, Xu, Xu, Xu, Xu, Xu
