border_size=1
usage=map

Ss, Xu, Ss, Xu, Xu, Qxu, Qxu, Qxu, Qxu, Qxu, Qxu, Qxu, Qxu, Xu, Xu, Xu, Xu, Xu, Xu, Xu, Xu, Xu, Xu, Xu, Xu, Xu, Xu, Xu, Xu, Xu, Xu, Xu
Xu, Ss, Xu, Ss, Wwg, Xu, Qxu, Qxu, Qxu, Qxu, Qxu, Qxu, Wwf^Uf, Qxu, Wwf, Uh^Dr, Uh, Uh, Uu, Xu, Xu, Xu, Uu, Xu, Uh, Uh, Uh^Em, Uh^Dr, Uh, Xu, Xu, Xu
Xu, Xu, Uue^Uf, Uue, Re^Em, Wwg, Uu, Uu, Uu, Qxu, Qxu, Qxu, Ss, Ss, Wwf, Uue^Em, Uue, Uue, Rb^Es, Rb, Uu, Uu, Re, Uu, Re, Uh, Rd, Uu, Uue, Uh, Uu, Xu
Xu, Xu, Uh^Uf, Uu, Xu, Xu, Qxu, Uu, Uue, Uu^Es, Re, Re, Re^Em, Re^Em, Re, Uue, Re, Re, Uu, Rb, Uu, Re, Uue, Rd, Re^Es, Rd^Es, Urb, Uue, Uue, Rb^Es, Uu, Xu
Xu, Uh, Re^Es, Uue, Xu, Qxu, Qxu, Uu, Urb, Uue, Uh, Ur, Uh, Uu, Xu, Uue, Xu, Uu, Xu, Xu, Xu, Uue, Uue, Uue, Re, Urb, Urb^Cov, Uue, Uue, Rb, Xu, Xu
Xu, Uh, Rd, Uue, Uu, Xu, Uue, Ur, Uu, Uu, Uh, Uh, Xu, Uh, Xu, Xu, Xu, Uu^Dr, Uu, Xu, Xu, Uu, Uue, Rb, Re^Es, Uu^Cov, Re^Cov, 2 Uu^Kov, Uue, Uu, Xu, Xu
Xu, Xu, Uh, Uh, Xu, Re, Uue, Ur, Uh^Dr, Xu, Xu, Xu, Xu, Xu, Xu, Xu, Xu, Xu, Urb, Xu, Uu, Xu, Uu, Uue, Re^Emf, Re^Cov, Uu^Uf, Uu^Cov, Uh^Cov, Uue, Xu, Xu
Xu, Xu, Xu, Xu, Xu, Rb, Wwf, Uue, Rb, Uh, Xu, Xu, Xu, Xu, Xu, Qxu, Qxu, Qxu, Qxu, Urb, Xu, Uu, Xu, Xu, Qxu, Uu^Uf, Qxu, Uh^Cov, Uh, Uh, Xu, Xu
Xu, Xu, Qxe, Xu, Uh^Dr, Uue, Wwf, Wwf^Em, Rr, Ur, Uu, Xu, Xu, Xu, Qxu, Qxu, Qxu, Qxu, Qxu, Xu, Xu, Xu, Xu, Xu, Xu, Qxu, Qxu, Qxu^Bp|, Qxu, Uh, Xu, Xu
Xu, Xu, Qxe, Uh, Uh, Uue, Re, Uue, Uue, Ur^Es, Ur, Uu, Uue, Uh^Uf, Uh^Uf, Qxu, Qxu, Xu, Rb, Xu, Xu, Xu, Xu, Xu, Xu, Qxu, Qxu, Qxu^Bp|, Qxu, Qxu, Xu, Xu
Xu, Qxu, Qxe, Uue, Uue, Uue, Rd^Em, Uu, Xu, Uu, Xu, Uue, Uu, Uue, Re, Qxu, Qxu, Uue, Xu, Rb, Uu, Xu, Xu, Xu, Xu, Qxu, Qxu, Qxu, Qxu, Qxu, Xu, Uh
Xu, Qxu, Qxu, Qxe, Uh^Uf, Uue^Uf, Rd^Uf, Xu, Xu, Xu, Cud, Xu, Ur, Re, Re, Uu, Uu, Qxu, Qxu, Qxu, Xu, Xu, Xu, Xu, Xu, Xu, Qxu, Qxu, Qxu^Bp\, Qxu, Uu, Uu
Xu, Qxu, Qxu, Qxu, Qxu, Uh^Uf, Xu, Xu, Xu, Cud, Cud, Uu, Uu, Ur, Rd, Uu, Uu, Xu, Xu, Xu, Xu, Xu, Xu, Xu, Xu, Xu, Xu, Qxu, Qxu, Uu, Urb, Urb
Xu, Xu, Xu, Qxu, Xu, Qxu, Xu, Xu, Xu, 3 Kud, Cud, Cud, Uu, Uu, Uue, Rd, Ur, Rd, Ur, Uu, Uu, Xu, Xu, Xu, Xu, Xu, Xu, Xu, Xu, Uu, Xu, Uu
Xu, Xu, Xu, Xu, Qxu, Qxu, Xu, Xu, Xu, Cud, Cud, Cud, Rb, Uue, Xu, Uue, Uue, Rr, Uu, Rb, Uu, Xu, Xu, Xu, Xu, Xu, Xu, Xu, Xu, Xu, Xu, Xu
Xu, Xu, Qxu, Qxu, Xu, Qxu, Xu, Xu, Xu, Xu, Xu, Xu, Qxu, Qxu, Qxu, Xu, Qxu, Qxu^Bs|, Qxu^Bs|, Qxu^Bs|, Qxu, Qxu, Qxu, Qxu, Qxu, Xu, Xu, Xu, Xu, Xu, Xu, Xu
Xu, Xu, Qxu, Xu, Xu, Xu, Xu, Xu, Xu, Xu, Xu, Qxu, Qxu, Xu, Xu, Qxu, Uu, Urb, Re, Uu, Uue, Qxu, Xu, Xu, Qxu, Qxu, Xu, Xu, Xu, Xu, Xu, Xu
Xu, Xu, Qxu, Xu, Xu, Xu, Xu, Xu, Xu, Xu, Xu, Qxu, Qxu, Xu, Uu^Uf, Uu, Re, Uu, Rd, Re, Uue, Uue, Xu, Xu, Xu, Qxu, Xu, Xu, Xu, Xu, Xu, Xu
Xu, Xu, Xu, Qxu, Qxu, Xu, Qxu, Xu, Xu, Xu, Xu, Qxu, Qxu, Qxu, Uu^Uf, Re, Rb, Xu, Xu, Xu, Urb, Urb, Xu, Xu, Xu, Xu, Xu, Xu, Xu, Xu, Xu, Xu
Xu, Xu, Xu, Xu, Xu, Qxu, Qxu, Qxu, Uh^Uf, Xu, Xu, Xu, Xu, Xu, Xu, Urb, Uu, Xu, Xu, Xu, Xu, Re, Re, Xu, Xu, Xu, Xu, Xu, Xu, Xu, Xu, Xu
Xu, Xu, Xu, Xu, Qxu, Qxu, Qxu, Qxu, Uh^Dr, Uh^Uf, Uh, Xu, Ur, Xu, Ur, Uu, Xu, Xu, Re, Xu, Uue, Rd, Rd, Uh, Uh^Dr, Xu, Xu, Xu, Xu, Xu, Ur, Ur
Xu, Xu, Xu, Xu, Xu, Qxu, Xu, Uh, Uh^Uf, Uu, Uue, Uu, Uue, Uu, Uu, Uu, Ur, Re, Uu, Uu, Uue^Es, Uue, Re, Re, Uh, Xu, Xu, Xu, Xu, Uue, Ur, Xu
Xu, Xu, Uu, Xu, Xu, Xu, Uh, Uu, Uu, Uu, Wwf, Uue, Urb, Uu^Uf, Uu, Ur, Uue, Uue, Qxe, Uu, Ur, Uue^Uf, Uue^Uf, Rd, Xu, Xu, Xu, Xu, Xu, Ur, Xu, Xu
Xu, Xu, Uh^Uf, Uu^Uf, Uue, Uh, Ur, Uu, Ur, Ur, Uue^Es, Wwf, Rr, Uue, Uh, Uue, Qxe, Qxe, Qxe, Qxe, Uh, Uh^Uf, Uh^Uf, Uue, Xu, Xu, Xu, Xu, Ur, Uh, Qxu, Xu
Uu, Rb^Uf, Rb, Uue^Uf, Uue, Urb, Uu, Ur, Re, Re, Uue, Uue, Uu, Uh, Uh^Uf, Wwf, Wog, Qxu, Qxu, Qxe, Xu, Xu, Xu, Xu, Xu, Xu, Xu, Xu, Ur, Uh, Qxu, Xu
Ur, Rb, 1 Urb, Uu, Uue, Urb, Uue, Rd^Es, Rd, Rd, Uh^Uf, Uh^Uf, Uh^Uf, Uh^Uf, Uu, Wwf, Qxe, Qxu, Qxu, Qxe, Qxe, Qxe, Qxe, Xu, Xu, Xu, Ur, Uue, Ur, Qxu, Qxu, Qxu
Ur, Uue, Uu, Ur, Uu, Uu, Uu, Uue, Xu, Uue, Xu, Uu^Uf, Qxe, Qxe, Qxe, Qxe, Qxe, Qxu, Xu, Qxu, Xu, Qxu, Uue, Uue, Uu, Uu, Uu, Ur, Qxu, Qxu, Qxu, Qxu
Uu, Uu, Uu, Uh, Uh, Uh, Xu, Xu, Xu, Xu, Xu, Xu, Xu, Qxu, Qxu, Qxu, Xu, Xu, Xu, Xu, Xu, Xu, Uu, Ur, Uh, Uh, Uh, Uh, Qxu, Qxu, Qxu, Qxu
