border_size=1
usage=map

Rr, Rr, Gg, Gll^Fp, Gll^Fp, Gll^Fp, Gd^Fms, Gg^Fms, Hh^Fp, Hh^Fp, Hh, Mm, Mm, Ms, Ha, Aa, Aa, Aa, Ai, Aa, Aa, Ha, Ha, Ms, Mm, Mm, Mm, Mm, Mm, Mm, Hh^Fmf, Hh, Gll^Fmf, Gd^Fp, Gd^Fp, Gg^Fp, Hh^Fmw, Hh^Fp, Hh^Fmw, Gg^Fms, Gll^Fmf, Gg^Fmw, Gll^Fmf, Gg^Fms, Gg, Gll^Fmf, Rd, Rd, Ds, Gll^Fp
Gg^Fds, Rr, Rr, Gd, Gll^Fp, Gll^Fp, Gll^Fp, Gd, Rd^Fms, Hh, Hh^Fp, Hh^Fp, Mm, Ms, Ms, Ha, Ms, Ha^Fda, Aa^Fpa, Wog, Wog, Ms, Ms, Ms, Mm, Hh^Fp, Hh^Fp, Mm, Hh^Fp, Hh^Fmf, Hh^Fms, Hh^Fmf, Gll^Fmw, Gd^Fmf, Gll^Fp, Gd^Fp, Gll^Fp, Gd^Fmw, Gll^Fmw, Gll^Fmf, Gll^Fmw, Gs^Fmw, Gs, Gd, Gd, Gd, Rd, Rd, Gg, Gll^Fp
Gd, Gs, Rr, Gs, Gll^Fmw, Gll^Fmw, Rd^Fp, Gd, Gd, Hh^Vhh, Hh^Fp, Hh^Fp, Hh^Fp, Mm, Mm, Mm^Xm, Ms, Ha, Ha^Fpa, Ha, Ha, Ha^Fpa, Ms^Xm, Mm, Mm, Hh^Fp, Hh^Fp, Hh^Fp, Hh^Fp, Hh^Fp, Hh^Fp, Hh, Hh^Fp, Gll^Fp, Gll^Fp, Gll^Fp, Gll^Fp, Gll^Fmw, Gs, Gll^Fp, Gs, Rd, Rd, Rd, Gd, Gd^Es, Gll^Fmw, Gg, Gll^Fmf, Gll^Fp
Gll^Fmw, Gs, Gs, Rr, Rp, Hh^Fp, Gs, Rd^Fp, Gd, Gs, Hh, Hh^Fp, Mm, Mm, Mm, Mm^Xm, Mm^Xm, Ms, Ms, Ha, Ms, Ha, Ms^Xm, Mm, Mm, Mm, Hh, Hh, Hh, Hh^Dr, Hh^Fp, Hh^Fp, Hh^Fp, Gll^Fmw, Ds, Ds^Fp, Gs, Gs, Gd, Gg, Gs, Gg, Rd, Ds, Gd, Gll^Fp, Gs^Fms, Gll^Fp, Gll^Fmf, Gll^Fp
Gll^Fmw, Gs^Fms, Gs^Fms, Rp, Rp, Gd, Gs, Gs^Fms, Gll^Fp, Gll^Fp, Gg^Fet, Hh^Fp, Hhd^Fmf, Hhd^Fmf, Hhd^Fmf, Mm, Mm, Ms^Xm, Mm^Xm, Ms, Ms, Ms, Mm^Xm, Mm, Hhd, 2 Ko, Co, Hh^Fp, Rp, Hh^Fp, Rp, Hh^Fp, Hh, Gs^Fp, Rd, Rd, Gd^Es, Gd, Gd^Fmw, Gll^Fmw, Gg, Gs, Rd, Gs, Gll^Fp, Gll^Fp, Gs, Gll^Fmw, Re^Fmw, Gll^Fmf
Gll^Fp, Gd^Fmw, Gd^Fp, Rr, Rp, Rd, Gs, Gg^Fms, Gll^Fp, Gd, Hh^Fp, Hh, Hh, Hhd^Fp, Hh^Fp, Hh^Fp, Mm, Mm, Mm, Mm^Xm, Ms^Xm, Ms^Xm, Mm, Mm, Hhd, Co, Co, Co, Hh^Fp, Rr, Hh, Rr, Rr, Rd, Gs, Ds, Gd^Fdw, Gll^Fmw, Gd^Fdw, Gd^Fmw, Gll^Fmw, Gs, Rd, Gs, Gs, Gll^Fp, Gs, Gs, Re^Fmw, Gll^Fmf
Gll^Fp, Gll^Fp, Gd^Fp, Gll^Fmw, Gs^Fp, Rp, Rr, Gg, Re^Gvs, Gd, Hh, Hh^Fp, Hhd^Fmw, Hhd, Hhd, Hh^Fp, Hh^Fp, Mm, Mm, Mm^Xm, Mm^Xm, Ms^Xm, Mm^Xm, Mm, Hhd, Hhd^Es, Co, Co, Hh^Fp, Hh^Fp, Hh^Fp, Hh^Es, Rr, Gs^Es, Gs, Gll^Fdw, Gd^Fdw, Gd^Fdw, Hhd^Fmw, Gd^Fmw, Gll^Fmw, Gg, Rd, Ds, Ds, Gs, Gs, Gs, Gs, Re^Fmw
Ww, Ww, Md, Gll^Fmw, Gll^Fmw, Gg^Vh, Rr, Rr, Rr, Gll^Fmw, Gll^Fmw, Hhd^Fmw, Hhd^Fmw, Gd, Hh, Hh^Fp, Hh^Fp, Hh^Fp, Mm, Mm, Mm, Mm^Xm, Mm^Xm, Mm, Mm, Mm, Hhd^Fmw, Hh^Fp, Hhd^Fmf, Hhd^Fp, Hh, Gg, Gg^Ve, Rr, Rp, Gll^Fdw, Gd^Fdw, Gd^Fdw, Ds, Hhd^Fmw, Hhd^Fmw, Ds, Rd, Ds, Gg, Gs^Es, Gg, Ds^Esd, Gg, Re
Wwf, Ww, Ds, Gd^Fp, Gll^Fp, Re^Gvs, Gs, Gs, Rr, Gg, Gd^Fmw, Gll, Hhd^Fmf, Hh, Hh^Fp, Hh^Fp, Hh^Fp, Hh^Fp, Hhd^Fmw, Mm, Mm, Mm, Mm, Mm^Xm, Mm^Xm, Mm, Hhd^Fmw, Hhd^Fmw, Hhd^Fmw, Hhd^Fmf, Hh^Fp, Gg, Gg^Fms, Gg^Fms, Rp, Gg, Gs, Gs, Hhd^Fp, Hhd^Dr, Hhd, Rd, Rd, Rd, Rd, Gs, Gd, Gs^Es, Gs, Gll^Fmw
Ww, Wwf, Ww, Ds, Gs^Fms, Gg, Gll^Fdw, Gll^Fdw, Rd, Rp, Gd, Gll, Hhd^Fmf, Hh^Fp, Gg^Fp, Hh^Fp, Hhd^Fp, Hhd^Dr, Hhd, Hhd^Fmw, Hhd^Fdw, Mm, Hhd^Fmw, Mm, Mm^Xm, Mm, Mm, Mm, Mm, Hhd^Fmw, Hh^Fp, Gs, Gs, Gg^Fms, Rp, Gg, Gd^Fms, Gd^Fp, Gll^Fp, Hhd, Mm, Mm, Ww, Rd, Gs, Rd, Rd, Gd^Es, Gg, Gg
Wwf, Ww, Ww, Ds, Gs^Fms, Gg, Rd, Gll^Fdw, Rd, Rp, Gll^Fp, Gd, Gll^Fp, Gd^Fdw, Gs^Fmw, Hhd^Fp, Gd^Fp, Gd, Hhd^Fmf, Hh, Gll^Fmf, Hhd^Fmw, Mm, Mm, Mm, Mm^Xm, Mm^Xm, Mm, Mm, Mm, Hh^Fp, Gg, Gs, Gg^Fms, Rr, Gg^Fms, Gd, Gd^Fp, Gll^Fmw, Ds, Ds^Ve, Ss, Ww, Ds, Ds, Gs, Gs, Rd, Rr, Rr
Wwf, Ww, Gll^Fp, Gd^Fp, Gd^Fmw, Gs^Fms, Rd, Gll^Fdw, Gll^Fmw, Rp, Rd, Gll^Fp, Gll^Fp, Gd, Gd^Fmw, Gs, Hh^Fp, Hhd^Fp, Gll^Fmf, Hhd^Fmf, Hh^Fmw, Hh, Hh, Mm, Mm, Mm^Xm, Mm, Mm, Mm, Hh^Fp, Hh^Fp, Gs, Gs, Gg^Fms, Rr, Gs, Gd, Gd^Fmw, Gd, Ds^Fmw, Ww, Ww, Ww, Mm, Gll^Fp, Ds, Ds, Rd, Gs, Rr
Ds, Wwf, Gll^Fp, Gd^Fp, Gll^Fp, Gll^Fp, Gd, Gll^Fmw, Gll^Fmw, Rp, Rp, Gll^Fp, Gll^Fp, Gll, Gll, Gll^Fmw, Re^Fmw, Hh^Fp, Hh^Fmf, Hh^Fmw, Gs^Fet, Hh^Fmw, Hh, Mm, Mm, Mm^Xm, Mm, Mm, Mm, Mm, Hh^Fp, Hh^Fp, Gs, Gg^Fms, Rr, Gs^Fms, Gs, Gd, Gll^Fmw, Ss, Ww, Wo, Ww, Ss, Gll^Fp, Gll^Fp, Rd, Rd, Gs, Gg
Gll^Fp, Ds^Em, Gd^Fmw, Gd^Fmw, Gll^Fmw, Gll^Fp, Gll^Em, Gd, Gd, Gg, Gg^Fms, Rd, Rd, Gg, Gs, Re, Gs, Hh^Fp, Hh^Fp, Gs^Fmw, Gd^Fmw, Hh^Fmw, Hh, Hh^Fp, Mm, Mm, Mm, Ds, Wo, Hh^Fp, Hh^Fp, Hh^Fp, Hh^Fp, Gg, Gg, Rp, Ce, Ce, Ce, Gll^Fmw, Gll^Fmw, Gs^Ve, Ww, Ww, Gll^Fmw, Rd, Gs, Gs, Ds, Ds
Gll^Fp, Gd^Fmw, Gd^Fmw, Gd, Gll^Fmw, Gll, Gll^Fmw, Rd, Rd, Gs, Gd, Gg, Mm, Rd, Rd, Re, Gs, Hh^Fp, Hh, Hh^Fp, Hh, Hh^Fp, Hh, Mm, Mm, Mm, Mm, Mm, Wwf, Wo, Hhd^Fmw, Hh^Fmw, Hh^Fp, Gs, Gs, Gg, Ce, 1 Ke, Ce, Gll^Fmw, Rd, Gll^Fmw, Rd, Gll^Fmw, Rr, Rr, Gg, Gd, Gd, Ds
Gll^Fp, Gd^Fmw, Gd^Fp, Gd, Gs, Gll^Fmw, Gll^Fmw, Gll^Fmw, Gll^Fp, Re, Gd, Ds, Mm, Hhd, Rd, Gs, Re, Hh, Hh, Hh, Hh, Hh, Mm, Hh^Fp, Hh^Fp, Hh^Fp, Ds, Hh, Wwf, Wwf, Ds, Hhd^Fmf, Hhd^Fp, Hh^Fp, Gs, Gg, Rr, Ce, Gll^Fp, Gd, Gd^Fmw, Rd, Gll^Fmw, Rd, Rr, Gg, Gll^Fp, Gs, Gd, Gd
Gll^Fp, Gll^Fp, Gll^Fp, Gll^Fp, Gll^Fp, Gg^Fet, Gll^Fp, Gd, Gd, Gll^Fp, Gs, Ds, Ds, Mm, Hh^Fp, Rd, Rp, Rp, Rp, Hh, Hh^Fp, Hh, Mm, Hh^Fp, Hh^Fms, Wo, Hh, Wwf, Hhd^Fp, Ds, Hhd, Hhd^Fmf, Hh, Hh^Fp, Hh^Fp, Rr, Gg, Gll^Fp, Gll^Fp, Gll^Fp, Gd^Fp, Gll^Fp, Gll^Fp, Gll^Fp, Gll^Fmw, Gll^Fp, Gll, Gg, Gs, Gd^Es
Gll^Fp, Ww, Ww, Gll^Fp, Gg^Ve, Gll^Fp, Gs, Gd, Gll^Fp, Gll^Fp, Ds, Gs, Gg^Ve, Ds, Hh^Fms, Hh^Fp, Hh^Fp, Gd, Hh^Fp, Rr, Rp, Rd, Rd, Hh, Re^Fp, Hh^Fms, Gs^Fms, Gd, Hh^Fp, Hhd, Hh^Fms, Hhd^Fds, Hh^Fms, Hh, Hh, Rr, Gs, Gll^Fp, Gd^Fp, Gll^Fmw, Gd^Fmw, Gll^Fp, Gd^Fmw, Gd^Fmw, Gd^Fms, Gd^Fp, Gg, Gg^Es, Ds, Gs
Gll^Fp, Gs^Fds, Ds, Ww, Ww, Ww, Ww, Gll^Fp, Gll^Fp, Gll^Fp, Gs^Fds, Gd^Fmw, Gd^Fmw, Hh^Fms, Hh, Hh^Fp, Hh^Fp, Hh^Fp, Gs, Rr, Gs, Ds, Rd, Re, Re, Gs^Fms, Gg, Gd, Hh, Hh^Fp, Hh^Fp, Hh^Fms, Hh^Fp, Hh, Gg^Fp, Rr, Rd, Gd^Fp, Gd^Fp, Gd^Fp, Gll^Fp, Gd^Fmw, Gd^Fmw, Gd^Fmw, Gll^Fp, Gd^Fp, Gd, Gs^Es, Hhd, Rd
Hhd, Gll^Fp, Gd, Ds, Ds, Gs, Gll^Fp, Ww, Gll^Fmw, Gd^Fmw, Gd^Fmw, Gd^Fmw, Gd^Fmw, Hh, Hh^Fp, Mm, Hh, Hh^Fp, Gd, Gg^Fms, Gs, Gs, Gs, Rd, Rd, Gs, Rp, Gs, Rp, Rr, Rr, Hh, Hh^Fp, Gg, Rr, Rr, Gll^Fp, Gll^Fp, Gd, Gll^Fp, Gd, Gll^Fp, Gll^Fp, Gll^Fp, Gll^Fp, Gll^Fp, Gd, Ds, Hhd^Es, Hhd
Hhd, Mm, Hhd, Gd, Hh, Hh, Hh, Gll^Fp, Gd^Fp, Gd^Fp, Gll^Fmf, Gd^Fp, Gll, Gg, Gll^Fp, Gll^Fp, Gg, Hh^Fp, Cv, Cv, Gs, Gs, Gs, Gd, Gll^Fmf, Rp, Gll^Fp, Rp, Gs, Gs, Gd^Dr, Rr, Rr, Rr, Gll^Fp, Gs, Gg, Gll^Fp, Gg, Gg, Gll^Fp, Gll^Fp, Ds, Ds, Mm, Mm, Hhd, Ds, Hhd, Ha^Fpa
Hhd, Hhd, Mm, Hh^Fp, Hh^Fp, Gs, Gs, Gll^Fp, Gs^Fp, Gll^Fp, Gll^Fmf, Gll^Fmf, Gll, Gg, Gs^Fdw, Gg, Rd, Rd, Gs^Fms, 3 Kv, Cv, Cv, Gll, Gg^Ve, Gd^Fmf, Gll^Fp, Hh, Gll^Fp, Gg, Gs, Gs^Es, Gg^Em, Gg^Em, Gll^Fp, Gll^Fp, Gs, Gll^Fp, Gg, Gll^Fp, Gll^Fp, Gs, Gs, Hhd, Hhd, Mm, Mm, Hhd, Ms, Ms, Ms
Mm, Mm, Mm, Hh^Fp, Gg, Gll^Fp, Gs, Gs, Gs^Fp, Gs^Fp, Gd^Fmw, Gll^Fmf, Gll^Fp, Gg, Gs, Gs^Fdw, Gd^Fmw, Gs^Fp, Gs^Fms, Cv, Cv, Cv, Gll, Gll^Fmf, Hh, Gll^Fp, Gll^Fp, Gll^Fp, Gg^Fet, Gs, Gs^Fdw, Gll^Fp, Gll^Fp, Gll^Em, Gll^Fp, Gll^Fp, Gll^Fp, Gll^Fp, Gll^Fp, Gll, Gll, Gll^Fp, Gs, Mm, Mm, Hhd^Es, Gll^Fp, Hhd, Ha, Ms
Hhd, Hhd, Hh, Hh, Gs, Gg, Gs, Chr, Gll^Fp, Gs^Fmw, Gd^Fmw, Gd^Fmw, Gll^Fp, Gg^Em, Gs, Gd^Fmw, Gs^Fdw, Gs^Fdw, Gs^Fdw, Gg^Em, Gg, Gll^Fp, Gll^Fp, Gll^Fmf, Hh, Hh, Gll^Fp, Gll^Fp, Gll^Fp, Gd^Fmw, Gd^Fmw, Gd^Fmw, Wwf, Gll^Fp, Gg, Hh, Hh, Gll^Fp, Hh, Gll^Fp, Gll^Fp, Gll^Fp, Gll^Fp, Hh, Gg, Gs, Hh^Fp, Gs, Hh, Ms
Gs^Fms, Hh, Chr, Ce, Gll^Fp, Gll^Fp, Gll^Fp, Gs, Gg^Em, Gd^Fmw, Gd^Fmw, Gd^Fmw, Gd^Fmw, Gll^Fp, Gll^Fp, Gd^Fmw, Gs, Gd^Fmw, Gd^Fmw, Gs^Fp, Gll, Gll^Fp, Gll^Fp, Gll^Fp, Gll^Fp, Gll^Fp, Ww, Ww, Wwf, Wwf, Ww, Gll^Fp, Ww, Wwf, Mm, Gg^Fds, Mm, Gg^Fds, Hh^Fp, Gll^Fp, Gll, Gll^Fp, Gll^Fp, Gs, Hh^Fp, Gll^Fp, Gs, Gll^Fp, Hhd, Ms
Gg, Gll^Fp, Gll^Fp, Rd, Gll^Fp, Gd^Fmw, Chr, Gg, Gs, Gd^Fmw, Hh^Fp, Gd^Fmw, Gll^Fp, Gd^Fmw, Gll^Fp, Gs, Gs, Gs, Gs, Gll, Gll, Gll^Fp, Gll^Fp, Hh, Hh, Gll^Fp, Gd^Fmw, Gd^Fmw, Gll^Fp, Wwf, Ww, Ww, Ww, Ww, Ww, Ww, Ds, Hh^Fp, Hh^Fp, Gll^Fp, Gll^Fp, Gll^Fp, Gll^Fp, Hh, Hh^Fp, Gll^Fp, Hh, Hh, Mm, Wo
Hh^Fp, Gll^Fp, Gll^Fp, Gll^Fp, Chr, Chr, Chr, 4 Khr, Gll^Fp, Gll^Fp, Hh, Gll^Fp, Rd, Rd, Gs, Gg, Gg, Gs, Gll^Fp, Gll^Fp, Gll^Fp, Gll^Fp, Gll^Fp, Gll^Fp, Hh, Gll^Fp, Gll^Fp, Gd^Fmw, Gll^Fp, Wwf, Gll^Fp, Wwf, Hh^Vhh, Hh^Fp, Mm, Mm, Ds, Hhd, Hhd, Gs^Fp, Gs^Fdw, Gll^Fp, Gll^Fp, Hh^Fp, Hhd^Fmw, Hh^Fp, Hh, Hh, Mm, Mm
Gll^Fp, Gll^Fp, Gll^Fp, Gll^Fp, Chr, Gd^Fmw, Chr, Chr, Gll^Fp, Gll^Fp, Gs, Gll^Fp, Gg, Gs, Gg, Gll^Fp, Gll^Fp, Gll^Fp, Gll^Fp, Gll^Fp, Hh, Gll^Fp, Hh, Gll^Fp, Gll^Fp, Gll^Fp, Gll^Fp, Gll^Fp, Hh, Gll^Fp, Hh^Fp, Ds, Ds, Hh, Hh, Mm, Hh^Fp, Hhd, Gs^Es, Gs, Gs^Es, Gs^Fdw, Hh^Fp, Hh^Fp, Hhd^Fmw, Hh, Mm, Mm, Hh, Mm^Xm
Gll^Fp, Gll^Fp, Gll^Fp, Gll^Fp, Gll^Fp, Chr, Hh, Chr, Gll^Fp, Gll^Fp, Gll^Fp, Gs, Chr, Gs, Gll^Fp, Gll^Fp, Gll^Fp, Hh, Gll^Fp, Hh, Hh, Gll^Fp, Gll^Fp, Hh, Gll^Fp, Gs, Gll, Gll^Fp, Gll^Fp, Hh, Hh, Hh^Fp, Hh^Fp, Wo, Hhd^Fmw, Hhd^Fmw, Hhd^Fmw, Hhd, Gd^Es, Gd^Dr, Gs^Fdw, Gs^Fdw, Hh^Fp, Wwrg, Gll^Fp, Ds, Mm, Mm, Mm, Hh
Gll^Fp, Gll^Fp, Gll^Fp, Gll^Fp, Gll^Fp, Gll^Fp, Gll^Fp, Hh, Gll^Fp, Gll^Fp, Gll^Fp, Gll^Fp, Gll^Fp, Gll^Fp, Gll^Fp, Gll^Fp, Gll^Fp, Gll^Fp, Mm, Hh, Gll^Fp, Gll^Fp, Gll^Fp, Hh, Hh, Gs^Em, Gll^Em, Gll^Fp, Gll^Fp, Gll^Fp, Hh, Hh, Hh^Fp, Hh^Fp, Hhd^Fmw, Hhd^Fmw, Hhd^Fmw, Gll^Fp, Gs^Fdw, Gd^Es, Gs^Fdw, Gll^Fp, Hhd^Fmw, Hh^Fp, Hh, Hh, Wwf, Mm, Mm, Mm^Xm
