border_size=1
usage=map

Wwf^Es, Wwrg, Wwg^Es, Gg, Gg, Gg, Gg^Es, Hh, Gs, Hh, Gs, Hh, Gs, Gs, Gg, Hh, Gg, Hh, Gg, Hh, Gs, Gll^Fp, Gg, Gll^Fp, Gs, Gll^Fp, Gll^Fp, Gll^Fp, Gll^Fp, Gll^Fp, Gll^Fp, Gll^Fp
Gg, Wwg^Es, Ww, Ww, Ww, Gg, Gs, Gs, Gs, Gg, Gs, Gs, Gg, Gg, Gs^Fds, Gs, Gg, Gg, Gg, Gg, Gg, Rp^Ve, Rp, Gg, Gs, Gg, Rrc, Gs^Fms, Rrc, Gs^Fms, Gg, Gll^Fp
Gg, Gg, Ww, Ww^Es, Ww, Gg, Gll^Fp, Gs^Fds, Gll^Fp, Gs, Gll^Fp, Gs, Gll^Fp, Gs^Fds, Gll^Fp, Gs^Fds, Gll^Fp, Gs^Fms, Gll^Fp, Gg^Es, Gll^Fp, Gg, Rp, Gs, Rrc, Rrc, Gs^Fms, Rrc, Gs^Fms, Rrc, Rrc, Rrc
Gll^Fp, Gs^Fds, Gs^Fds, Ww, Ww, Ww, Ww, Gll^Fp, Gs^Fms, Gs^Fms, Hh^Fms, Hh^Fms, Gs^Fms, Gs^Fms, Gs^Fms, Gs^Fms, Gll^Fp, Gs^Fms, Gg, Gs^Fms, Gll^Fp, Gs^Fms, Rrc, Rrc, Gs, Gs^Em, Gs^Fms, Gg, Gs^Fms, Gs^Fms, Gs^Fms, Gs^Fms
Gll^Fp, Gs^Fds, Gs^Fds, Ww, Ww^Es, Ww^Es, Ww, Gs^Fms, Gs^Fds, Gs^Fms, Hh^Fds, Hh^Fms, Gs, Gs^Fms, Gs^Fet, Gs^Fms, Gs^Fms, Gs^Fms, Re, Gs^Fms, Rrc, Rrc, Gs^Fms, Rp, Rp, Gs^Fms, Gs^Fms, Gs^Fms, Gs^Fms, Gll^Fp, Hh^Fp, Gs^Fms
Gs^Fds, Gs^Fds, Hh, Gs^Fds, Ww, Ww, Wo, Ww^Es, Wwr, Gs^Fms, Hh^Fms, Hh, Gll^Fp, Re, Gs^Efm, Gs^Fms, Gs^Fms, Gs^Fds, Gs^Fms, Gg, Rrc, Gg, Gs^Fms, Gg, Rp, Gll^Fp, Gs^Fms, Gs^Fds, Gs^Fms, Gs^Fms, Gs^Fms, Gs^Fms
Gs^Fds, Gs^Fms, Gll^Fp, Gs^Fds, Ww^Es, Wo, Wwr, Wwr, Wo^Es, Gs^Fds, Ww^Es, Gs^Fds, Gs^Fms, Gg, Rp, Gg, Rp, Gs^Fms, Rrc, Rrc, Gs^Fms, Gs^Fds, Gs^Fms, Gs^Efm, Gll^Fp, Rp, Rr^Ve, Gs^Fms, Gs^Fms, Gg, Gs^Fms, Gs^Fms
Gs^Fds, Gs^Fds, Gs^Fds, Gs^Fds, Hh^Fds, Ww^Es, Gs^Fds, Wo^Es, Wo, Ww^Es, Wwr, Gs^Fms, Gs^Fms, Gll^Fp, Gll^Fp, Rp, Gs^Fms, Rrc, Gs, Gs, Gs^Fms, Gs^Fms, Hh^Fms, Gs^Fms, Gs^Fds, Gs^Fms, Gs^Fms, Rp, Rp, Gs^Em, Gll^Fp, Gs^Fms
Rp, Gs^Fds, Gs^Fds, Gs^Fms, Gs^Fds, Gs^Fds, Gs^Fds, Wo, Wwr, Wo, Wo, Gs^Fds, Gs^Fms, Gll^Fp, Gs^Fms, Gs^Fms, Ww, Rrc, Ww, Gs^Fms, Gs^Fms, Gll^Fp, Gll^Fp, Ss, Gs^Fms, Gs^Fms, Gs, Gd, Gg^Fet, Gs, Gs^Fds, Gs^Fms
Gs^Fds, Rrc^Ve, Hh, Gs^Fds, Hh, Gs^Fds, Ss, Wwg^Es, Gs^Fds, Wo^Es, Wo^Es, Ww^Es, Wwr, Gs^Fms, Ww, Gs^Fds, Ww, Ww^Bsb|, Ww, Gs^Fds, Ww, Gs^Fms, Gs^Fms, Hh^Fms, Gs^Fms, Gg, Gs, Gs, Rp, Gd, Gs^Fms, Hh^Fms
Gs^Fds, Gs^Fds, Gd^Fdw, Gs^Fms, Gs^Fds, Hh^Fms, Gs^Fds, Gs^Fds, Gs^Fds, Ww^Es, Wwr, Wwr, Wo^Es, Gs^Fds, Ww, Ww, Cv^Fet, Ww^Bsb|, Cv^Fet, Ww, Ww, Gs^Fds, Gs^Fds, Gs^Fms, Gll^Fp, Gs^Efm, Gs^Fms, Gs^Fms, Gll^Fp, Rp, Gll^Fp, Hh^Fms
Gs^Fms, Gs^Fds, Gs^Fds, Gs^Fds, Gs^Fds, Gs^Fds, Gs^Fds, Gs^Fds, Gs^Fds, Ww^Es, Gs^Fds, Wo^Es, Wo, Ww, Ww, Ww, Cv, Rp, Cv, Ww, Ww, Ww, Ww, Gs^Fms, Gs^Fms, Gs^Fms, Gs^Em, Gs^Fms, Gd, Rp, Gs^Fms, Gs^Fms
Gll^Em, Gll^Fp, Gll^Fp, Gs^Fds, Gs, Gs, Gs, Gg, Re^Gvs, Gs^Fds, Gs^Fds, Ww, Ww, Ww, Cv^Fet, Cv, Gs^Efm, Gs, Gs^Efm, Cv, Cv^Fet, Ww, Ww, Gs^Fds, Gs^Fms, Gs^Fms, Gs^Fms, Gs^Fds, Gs^Fms, Gg, Gs^Fms, Gs^Fms
Gs^Fds, Gll^Fp, Gs^Fds, Gs^Fds, Gs, Gs^Fet, Gll^Emf, Re^Gvs, Re^Gvs, Re, Ww, Ww, Ww, Ww, Cv, Gs^Efm, Gs^Efm, 2 Kv, Gs, Gs^Efm, Cv, Ww, Ww, Ww, Ww, Gs^Fms, Ss, Gs^Fp, Rp, Rp, Gs^Fms, Gs^Fms
Gs^Fms, Gs^Fds, Gs^Fds, Gg, Gg^Efm, Gll^Emf, Ss, Gg, Gs^Fds, Re, Ww, Ww^Es, Ww, Cv, Gg^Emf, Gs, Gs^Efm, Wwt^Ewf, Gs^Efm, Gs, Gg^Emf, Cv, Ww, Ww, Ww, Gs^Fms, Gs^Fp, Rp, Gs^Fms, Gs^Fds, Gs^Fms, Gs^Fms
Hh^Fds, Hh, Gs^Fds, Gg^Efm, Gs^Fds, Ss, Ss, Gs^Fds, Gs^Fds, Gs^Fds, Gs^Fds, Ww, Ww, Cv, Cv, Kv, Cv, Gs^Efm, Cv, 3 Kv, Cv, Cv, Ww, Ww, Gs^Fms, Gs^Fms, Gs^Fms, Gs, Rp, Gs^Fms, Gll^Fp, Gs^Fms
Gs^Fds, Gs^Fds, Hh^Fp, Gs^Fms, Gs^Fds, Gs^Fds, Gs^Fds, Gs^Fds, Gs^Fms, Gs^Fds, Gs^Fds, Ww, Ww, Cv^Fet, Ww, Wwg, Cv, Gs^Efm, Cv, Wwg, Wwr, Cv^Fet, Ww, Ww, Gs^Fds, Hh^Fds, Gll^Fp, Gs^Fms, Rp, Gll^Fp, Gs^Fms, Gs^Fms
Hh, Hh^Fms, Re^Gvs, Gs^Fds, Gll^Fp, Gs^Fms, Gs^Fds, Gs^Fds, Mm, Gs^Fds, Gs^Fds, Ww, Wwf, Ww, Ww, Cv, Cv, Gs, Cv, Cv, Ww, Ww, Wo^Es, Ww^Es, Gs^Fds, Gs^Fms, Gs^Fms, Gs^Fms, Gs, Rp, Rp^Ve, Gs^Fms
Gs^Fds, Hh^Fp, Re^Ve, Gs^Emf, Gll^Fp, Gs^Fds, Gs^Fds, Gs^Fms, Gs^Fds, Gs^Fds, Gs^Fds, Gs^Fds, Gs^Fds, Ww, Ww, Cv^Fet, Ww, Rp, Ww, Cv^Fet, Ww, Wwr, Wo^Es, Wwr, Wwr, Gs^Fms, Ww^Es, Gs^Fms, Gs^Fms, Gs^Fms, Gs^Fms, Gs^Fms
Gs^Fds, Re^Gvs, Re^Gvs, Gg^Efm, Gs, Gs^Fds, Gs^Es, Gs^Fds, Gs^Fds, Gs^Fds, Hh^Em, Gs^Fds, Gs^Fds, Ww, Gs^Fds, Ww, Ww, Ww^Bsb|, Ww, Ww, Gs^Fds, Wo^Es, Wwr, Wwr, Wo^Es, Gs^Fds, Ww^Es, Gs^Fds, Ww^Es, Hh^Fp, Gs^Fms, Gs^Fms
Gs^Fms, Gs^Fds, Gs^Fms, Gs^Fds, Gs^Fds, Gs, Gs^Fds, Gs, Gg, Gs^Fds, Gs^Fds, Gs^Fds, Gll^Fp, Gs^Fds, Gs^Fds, Ww, Cv^Fet, Ww^Bsb|, Cv^Fet, Ww, Gs^Fds, Ww^Es, Gs^Fds, Wo^Es, Wwr, Wwr, Wo^Es, Wwr, Wo^Es, Gs^Fds, Ww^Es, Gs^Fms
Gll^Fp, Hh, Gs^Fds, Hh, Hh^Fds, Gs^Fds, Gs^Fds, Gll^Fp, Gs^Fds, Gs^Fds, Gs^Fms, Hh, Gs^Fds, Gll^Fp, Gs^Fds, Gs^Fds, Gs^Fds, Rrc, Gs^Fds, Gs^Fds, Hh^Fds, Gs^Fds, Wwf, Ww^Es, Gg, Wo^Es, Wwr, Wo^Es, Wwr, Wwr, Wo^Es, Ww^Es
Gs^Fds, Gll^Fp, Hh^Fds, Hh^Fds, Gs^Fds, Gs^Fds, Ss, Gs^Fds, Hh, Gs^Fms, Gll^Fp, Gs^Fds, Re^Gvs, Re^Gvs, Gs^Fds, Gs^Fds, Gg^Es, Rrc, Gg, Hh^Fds, Gs^Fds, Gs^Fds, Wwf, Gs^Fds, Gs^Fds, Ww^Es, Gs^Fds, Ww^Es, Gs^Fms, Wo^Es, Re^Ve, Wo^Es
Hh^Fds, Gs^Fds, Hh^Fds, Gs^Fms, Gs^Em, Ss, Ss, Gs^Fds, Gs^Fds, Gs^Fms, Gs^Fms, Gs^Fds, Gs^Fds, Gg, Gs^Fds, Gs, Rrc, Rrc, Gg, Gs^Fds, Gs^Fds, Wwf, Hh^Fds, Gs^Fds, Gs^Fds, Gs^Fds, Gs^Fds, Gs^Fds, Gs^Fds, Ww^Es, Re, Gs^Fds
Hh^Fds, Hh^Fds, Gs^Fds, Gs^Fds, Gs^Fds, Gs^Fds, Gg, Gs, Gd^Fdw, Gd^Fdw, Gs^Fds, Gs^Fds, Gs^Fds, Gs^Fds, Rrc, Rrc, Gs^Fds, Gs, Gs^Fds, Gg^Efm, Gs^Fds, Wwf, Hh^Fms, Gs^Fds, Gll^Fp, Hh^Fms, Hh^Fds, Gs^Fds, Hh^Fds, Gs^Fds, Re, Gs^Fds
Gd^Fms, Gs^Fds, Gs^Fds, Gs^Fds, Hh, Gg^Efm, Gg^Efm, Gs^Fds, Gs^Fds, Gd^Fdw, Gs^Fds, Gs^Fds, Rrc, Rrc, Gs, Gg, Gs^Fds, Gs, Gs^Fds, Gs^Fds, Hh^Fds, Wwf, Gs^Fds, Gs^Fds, Gs^Fds, Hh^Fds, Gll^Fp, Hh^Fms, Hh^Fds, Re^Es, Gs^Fms, Gs^Fms
Gd^Fdw, Gd^Fds, Gs^Fms, Gs^Fds, Gs^Fds, Gs^Fms, Gs^Fds, Gs^Fds, Gs^Fds, Gs^Fds, 1 Rrc, Rrc, Gs^Fds, Gs, Gs^Fds, Gs^Fds, Gs^Fds, Gs^Fds, Wwf, Hh^Fds, Wwf, Wwf, Hh^Fms, Gg, Gs^Fds, Gs^Fds, Gs^Fds, Gs^Fds, Gs^Fds, Re, Gs^Fds, Gs^Fms
Gd^Fms, Gd^Fds, Gs^Fds, Gs^Fds, Rp, Gs^Fms, Rp, Rp, Rr, Gs^Fds, Rrc, Gs^Fds, Gs^Fms, Gs^Fds, Hh^Fds, Gs^Fds, Wwf, Wwf, Hh^Fms, Wwf, Gs^Fds, Gs^Fds, Gs^Fds, Re, Gll^Fp, Gs^Fds, Gll^Fp, Gs^Fds, Gs^Fds, Re, Gs^Fds, Gs^Fds
