border_size=1
usage=map

Xu, Xu, Xu, Xu, Xu, Xu, Xu, Xu, Xu, Xu, Xu, Xu, Xos, Xos, Xos, Xos, Xos, Xos, Xos, Xos, Xos, Xos, Xol, Xu, Xu, Xu, Xu, Xu, Xu, Xu, Xu, Xu, Xu, Xu, Xu, Xu, Xu, Xu, Xu
Xu, Xu, Xu, Xu, Xu, Xu, Xu, Xu, Xu, Xu, Xu, Xos, Xu, Xos, Xos, Xos, Xos, Xos, Xos, Xos, Xos, Xos, Xos, Xol, Xos, Xu, Xu, Xu, Xu, Xu, Xu, Xu, Xu, Xu, Xu, Xu, Xu, Xu, Xu
Xu, Xu, Xu, Xu, Xu, Xu, Xu, Xu, Xu, Xu, Xu, Xu, Xu, Xu, Xu, Xu, Xos, Xos, Xos, Xos, Xos, Xos, Xos, Xos, Xos, Xos, Xos, Xu, Xu, Xu, Xu, Xu, Xu, Xu, Wog, Xu, Xu, Xu, Xu
Xu, Xos, Xos, Xu, Xos, Xu, Qxu, Xu, Xu, Xu, Qxu, Xu, Qxu, Xu, Qxu, Xu, Xu, Xos, Xos, Xos, Xos, Xos, Xos, Xos, Xos, Xos, Xos, Xu, Xu, Xu, Xu, Xu, Wog, Wog, Xu, Xu, Xu, Xu, Xu
Xos, Xos, Xos, Xos, Xos, Qxu, Xos, Qxu, Qxu, Qxu, Qxu, Qxu, Xos, Qxu, Xos, Qxu, Xu, Xu, Xu, Xos, Xos, Xos, Xos, Xos, Xos, Xos, Xos, Xu, Xu, Xu, Xu, Xu, Wog^Xo, Xu, Xu, Xu, Xu, Xu, Xu
Xos, Xos, Urb, Ur, Urb, Xos, Xos, Qxu, Qxu, Qxu, Qxu, Xol, Xos, Xol, Xos, Xos, Xos, Xos, Xos, Xos, Xos, Xos, Xos, Xos, Xos, Xos, Xu, Xu, Xu, Xu, Qxu, Xu, Wog, Wog, Wog, Xu, Xu, Xu, Xu
Xos, Urb, Urb, Urb, Urb^Ng/, Xos, Cud, Cud, 2 Kud, Cud, Cud, Xos, Xos, Xos, Xos, Xos, Xos, Xos, Xos, Xos, Xos, Xos, Xos, Xos, Xol, Xos, Xu, Xu, Xu, Qxu, Qxu, Qxu, Qxu, Wog, Wog, Wog, Xu, Xu, Xu
Xu, Xos, Xol, Xol, Ur, Urb, Urb, Cud, Urb, Cud, Urb, Cud, Cud, Xos, Xos, Xos, Xos, Xos, Xos, Xos, Xos, Xos, Xos, Xos, Xos, Xos, Xu, Xu, Xol, Xu, Urb, Qxu, Qxu, Xu, Wog, Wog, Xu, Xu, Xu
Xu, Xu, Urb^Bzl, Ur, Urb, Urb, Urb, Ur, Ur, Urb, Urb, Urb, Cud, Xos, Xos, Xos, Xos, Xos, Xos, Xos, Xos^Zos, Xos^Zos, Xos^Zos, Xos, Xu, Xu, Xu, Xol, Uu, Uh, Uue, Ur, Urb, Xos, Wog, Wog, Wog, Xu, Xu
Xos, Xu, Urb, Urb, Urb, Urb, Xos, Ur, Ur, Urb, Urb, Cud, Xol, Xos, Xos, Xos, Xos, Xos, Xol^Zos, Xos^Zos, Urb^Zos, Xos^Zos, Xos^Zos, Xu, Qxu, Qxu, Uh, Uh^Uf, Uh^Uf, Uh, Ur, Ur, Urb, Uue, Urb, Wog, Wog, Wog, Wog
Xos, Xu, Xu, Urb, Xos, Xos, Xuc, Xos, Urb, Urb, Urb, Xos, Xos, Xol, Xos, Xos, Xos, Xol, Urb^Ngl\, Urb^Zos, Urb^Zos, Urb^Zos, Urb^Zos, Xu, Xu, Qxu, Uue, Uu, Urb, Urb, Uu, Urb, Urb, Ur, Uu, Xos, Xu, Wog, Wog
Xos, Xos, Xos, Xuc, Xuc, Xuc, Uu, Urb, Urb, Urb, Urb, Xos, Xos, Xos, Xol, Xol, Xos, Urb, Urb, Urb^Ngl\, Urb^Ngl\, Urb^Zos, Xos, Xos, Xos, Xu, Uh, Uue, Uu, Uu, Urb, Urb, Urb, Uu, Urb, Xos, Xos, Xos, Qxu
Xos, Xos, Xuc, Xuc, Uu, Uu, Xuc, Urb, Ur, Urb, Ur, Xos, Xol, Xos, Xos, Xos, Xos, Urb, Urb, Urb, Xos, Xos, Xos, Xos, Xos, Xos, Xos, Uh, Urb, Urb, Urb, Urb, Urb, Urb, Xol, Xol, Qxu, Qxu^Xo, Xos
Xuc, Xuc, Ql, Xu, Uu, Xuc, Xos, Urb, Urb, Urb, Xos, Xol, Xos^Zos, Xos^Zos, Xos^Zos, Xos, Xos, Urb, Urb, Urb, Xos, Xos, Xos, Xos, Xos, Xol, Urb, Urb, Ur, Urb, Xos, Urb, Urb^Ng/, Urb^Ng/, Urb, Urb, Urb, Xos, Xos
Xu, Xu, Ql, Uu, Qxu, Qxu, Qxu, Urb, Urb, Urb, Xos, Xos, Urb, Urb^Zos, Urb^Zos, Xos^Zos, Xos, Urb, Urb, Urb, Xos, Xos, Xol, Xol, Urb, Urb, Xos, Xos, Xos, Xol, Urb, Xos, Urb, Ur, Urb, Urb, Urb, Urb, Xos
Qlf, Qlf, Xu, Ql, Ql, Ql, Qxu, Qxu, Urb, Ur, Ur, Urb^Ngl\, Urb^Ngl\, Urb, Xol, Xos, Qxu^Xo, Urb, Urb, Urb, Urb, Xos, Urb^Xo, Urb, Xos, Xos, Xos, Xos, Xos, Urb, Urb, Ur, Ur, Ur, Ur, Urb, Cud, Urb, Xos
Ql, Xu, Xu, Xu, Ql, Qxu, Qxu, Qxu, Qxu, Ur, Urb, Urb, Urb, Xol, Xol, Xol, Qxu^Xo, Urb, Urb, Urb, Urb, Urb, Urb, Xos, Xos, Xos, Xos, Xos, Xol, Urb, Urb, Ur, Urb, Ur, Cud, Urb^Bzl, 3 Kud, Cud, Xos
Xu, Xu, Qxu, Qlf, Qxu, Ql, Xuc, Qxu, Xos, Urb, Urb, Urb, Urb, Ur, Ur, Qxu^Xo, Qxu^Xo, Qxu^Xo, Xos, Urb, Urb, Urb, Urb, Xos, Xos, Xos, Xos, Xos, Xos, Xos, Xos, Urb, Xos, Cud, Qxu, Cud, Cud, Cud, Xos
Qlf, Xu, Ql, Qxu, Qlf, Xu, Xu, Xuc, Xuc, Xos, Urb, Urb, Urb, Urb, Urb, Urb, Urb, Xos, Xos, Xos, Urb, Urb, Urb, Xos, Xos^Zos, Xos, Xos^Zos, Xos, Xos, Xos, Xos, Xos, Xos, Cud, Cud, Cud, Xos, Xos, Xos
Qlf, Qlf, Ql, Ql, Qxu, Xu, Xu, Xu, Xu, Xos, Xos, Urb, Urb, Urb, Xos, Urb, Urb, Urb, Urb^Xo, Xos, Urb, Urb, Urb, Xos, Qxu, Qxu^Zos, Qxu^Zos, Xos^Zos, Xos^Zos, Xos, Xos, Xos, Xos, Xos, Xos, Xos, Xos, Xos, Xos
Xu, Xu, Xu, Xu, Qlf, Qlf, Uu, Xu, Xu, Xu, Xu, Xos, Xos, Xos, Xos, Xos, Xos, Urb^Xo, Urb, Urb, Urb, Urb, Urb, Cud, Cud, Qxu, Qxu, Qxu^Zos, Qxu^Zos, Xos^Zos, Xos^Zos, Xos, Xos, Xos, Xos, Xos, Xos, Xos, Xos
Xu, Xu, Qxu, Qxu, Xu, Qlf, Ur, Uu, Xu, Xu, Xos, Xu, Xos, Xos, Xos, Xos, Ur, Urb^Xo, Xos, Urb, Urb, Urb, Urb, Urb, Urb, Cud, Cud, Qxu, Qxu, Qxu^Zos, Qxu^Zos, Xos, Xos, Xos, Xos, Xos, Xos, Xos, Xos
Xu, Xos, Qxu, Xu, Xu, Qxu, Qxu, Ur, Xos, Xos, Xos, Xos, Xos, Xos, Urb, Urb, Xos, Xos^Zos, Qxu^Zos, Qxu, Qxu, Urb, Urb, Urb, Urb, Urb, Urb, Cud, Cud, Qxu, Xos, Xos, Xos, Xos, Xos, Xos, Xos, Xos, Xos
Xu, Xos, Xos, Qxu, Qxu, Qxu, Qxu, Xos, Xos, Xos, Xos, Xos, Urb, Urb, Xos, Xos, Xos, Xos, Xos, Qxu^Zos, Qxu^Zos, Qxu, Xos, Urb, Urb, Urb, Urb, Urb, Xos, Xos, Xos, Xos, Xu, Xos, Xos, Xos, Xos, Xos, Xos
Xu, Xos, Xos, Qxu, Qxu, Qxu, Xos, Xos, Xol, Xol, Ur, Ur, Urb, Xos, Xos, Xos, Xos, Xos, Xos, Xos, Xol, Xos, Urb, Xos, Urb^Ng\, Urb, Urb, Urb, Urb^Ng/, Xos, Xu, Xu, Xu, Xu, Qxu, Xos, Xos, Xos, Xu
Xu, Xu, Qxu, Qxu, Xos, Xos, Cud, Cud, Urb, Urb, Urb, Urb, Urb, Cud, Cud, Xos, Xos, Xos, Xos, Xol, Urb, Urb, Urb, Urb, Urb, Urb^Ng\, Xos, Urb^Ng/, Ur, Urb^Bzn, Urb, Uue, Uue, Uh^Uf, Uh, Qxu, Xu, Xu, Xu
Qxu, Qxu, Xos, Xos, Xos, Cud, Kud, Cud, Cud, Urb, Urb, Urb, Urb, Cud, Xos, Xos, Xol, Xos, Xos, Urb, Urb, Urb, Urb, Urb, Xos, Xos, Xu, Urb^Bzn, Ur, Urb, Urb, Urb, Ur, Uh, Ur, Qxu, Xu, Xu, Xu
Qxu, Xu, Xu, Xos, Xos, Cud, Cud, Cud, Xos, Ur^Bzn, Urb, Urb, Urb^Ng/, Xos, Urb^Ng\, Urb, Urb, Xol, Xos, Urb, Urb, Urb, Urb, Xos, Xu, Xu, Uu, Urb, Urb, Ur, Urb, 1 Urb, Urb, Urb, Ur, Ur, Xos, Xu, Xu
Qxu, Xu, Xu, Xos, Xos, Xos, Ql, Cud, Xol, Xos, Xos, Urb^Ng/, Urb, Urb, Urb, Urb^Ng\, Xos, Xos, Urb, Xol, Xol, Urb, Xos, Xos, Uh^Uf, Uue, Uu, Urb, Ur, Urb, Urb, Urb, Urb, Uue, Uu, Uu, Xos, Xu, Xu
Xu, Qxu, Xu, Xos, Xos, Ql, Xos, Xol, Urb, Urb, Ur, Urb^Ng\, Urb^Ng\, Urb, Urb, Urb, Urb, Urb^Ng\, Urb^Ng\, Urb, Xol, Xos, Xos, Xos, Xos, Uh, Uh, Uue, Uue, Ur, Uu, Uu, Uu, Uu, Uue, Xu, Xu, Xu, Xu
Xu, Qxu, Xuc, Xos, Ql, Ql, Xos, Xos, Xos, Ur, Ur, Urb, Xos, Xos, Urb^Ng\, Ur, Ur, Urb, Urb, Xos, Xol, Xol, Xu, Xu, Qxe, Uh, Urb, Uue, Urb, Uu, Uh^Uf, Uh, Uh, Urb, Qxu, Xu, Xu, Xu, Xu
Qxu, Qxu, Qlf, Qlf, Ql, Ql, Xos, Xos, Xos, Xos, Xos, Xos, Ur, Urb, Urb, Urb^Ng\, Xos, Urb, Urb^Ng/, Urb^Ng/, Urb^Bzn, Uh, Uh, Xu, Qxe, Qxe, Qxe, Qxu, Xu, Xu, Xos, Uh^Uf, Xos, Qxu, Qxu, Qxu, Xu, Xu, Xu
Qxu, Qxu, Qxu, Qxu, Qxu, Xuc, Xuc, Xos, Qxu, Xos, Xos, Urb, Urb, Urb, Urb, Xos, Xol, Xol, Urb^Bzn, Urb, Ur, Urb, Urb, Uue, Qxu, Qxe, Xu, Xu, Xu, Xu, Xu, Xos, Xos, Xos, Qxu, Qxu, Qxu^Xo, Xu, Xu
Xos, Qxu, Xos, Xos, Xos, Qxu, Qxu, Qxu, Qxu, Qxu, Uu^Ngl/, Xos, Qxu, Urb, Xos, Xos, Xu, Urb, Uu, Urb, Ur, Uu, Urb, Uue, Urb^Uf, Qxu, Xu, Xu, Xu, Xu, Xu, Xu, Xu, Xu, Xu, Qxu^Xo, Qxu^Xo, Xu, Xu
Xu, Xos, Xu, Xos, Xos, Xos, Xos, Xu, Xu, Xos, Xos, Qxu, Qxu, Qxu, Uu^Ngl/, Xos, Urb^Uf, Uu, Uu, Urb, Uh, Urb, Urb, Urb, Xos, Qxu, Xu, Xu, Xu, Xu, Xu, Xu, Xu, Xu, Xu, Xu, Xu, Qxu, Qxu
Xu, Xu, Xu, Xu, Xu, Xu, Xu, Xu, Xu, Xu, Xu, Xos, Xos, Xos, Xos, Qxe, Qxe, Uh, Uh, Uh, Uu^Uf, Uh^Uf, Uh^Uf, Uh, Xos, Xu, Xu, Xu, Xu, Xu, Xu, Xu, Xu, Xu, Xu, Xu, Xu, Qxu, Qxu
Xu, Xu, Xu, Xu, Xu, Xu, Xu, Xu, Xu, Xu, Xu, Xu, Xu, Xu, Xos, Xos, Qxe, Qxe, Qxe, Qxe, Xu, Xos, Xos, Xos, Xu, Xu, Xu, Xu, Xu, Xu, Xu, Xu, Xu, Xu, Xu, Xu, Xu, Qxu, Qxu
