border_size=1
usage=map

Xu, Xu, Xu, Xu, Xu, Xu, Xu, Xu, Xu, Xu, Xu, Xu, Xu, Xu, Xu, Xu, Xu, Xu, Xu^Zos, Xu^Zos, Xos^Zos, Xos^Zos, Urb^Zos, Urb^Zos, Urb^Zos, Xos^Zos, Xos^Zos, Xu^Zos, Xu, Xu, Xu, Xu, Xu, Xu, Xu, Xu, Xu, Xu, Xu, Xu, Xu, Xu, Xu, Xu, Xu, Xu, Xu, Xu, Xu, Xu
Xu, Xu, Xu, Xu, Xu, Xu, Xu, Xu, Xu, Xu, Xu, Xu, Xu, Xu, Xu, Xu, Xu, Xu, Xu^Zos, Xu^Zos, Xos^Zos, Xos^Zos, Urb^Zos, Urb^Zos, Urb^Zos, Xos^Zos, Xos^Zos, Xu^Zos, Xu, Xu, Xu, Xu, Xu, Xu, Xu, Xu, Xu, Xu, Xu, Xu, Xu, Xu, Xu, Xu, Xu, Xu, Xu, Xu, Xu, Xu
Xu, Xu, Xu, Xu, Xu, Xu, Xu, Xu, Xu, Xu, Xu, Xu, Xu, Xu, Xu, Xu, Xu, Xu, Xu^Zos, Xu^Zos, Xos^Zos, Xos^Zos, Urb^Zos, Urb^Zos, Urb^Zos, Xos^Zos, Xos^Zos, Xu^Zos, Xu, Xu, Xu, Xu, Xu, Xu, Xu, Xu, Xu, Xu, Xu, Xu, Xu, Xu, Xu, Xu, Xu, Xu, Xu, Xu, Xu, Xu
Xu, Xu, Xu, Xu, Xu, Xu, Xu, Xu, Xu, Xu, Xu, Xu, Xu, Xu, Xu, Xu, Xu, Xu, Xu^Zos, Xu^Zos, Xos^Zos, Xos^Zos, Urb^Zos, Urb^Zos, Urb^Zos, Xos^Zos, Xos, Xu, Xu, Xu, Xu, Xu, Xu, Xu, Xu, Xu, Xu, Xu, Xu, Xu, Xu, Xu, Xu, Xu, Xu, Xu, Xu, Xu, Xu, Xu
Xu, Xu, Xu, Xu, Xu, Xu, Xu, Xu, Xu, Xu, Xu, Xu, Xu, Xu, Xu, Xu, Xu, Xu, Xu^Zos, Xu^Zos, Xos^Zos, Xos^Zos, Urb^Zos, Urb^Zos, Urb, Xos, Xos, Xu, Xu, Xu, Xu, Xu, Xu, Xu, Xu, Xu, Xu, Xu, Xu, Xu, Xu, Xu, Xu, Xu, Xu, Wog, Xu, Xu, Xu, Xu
Xu, Xu, Xu, Xu, Xu, Xu, Xu, Xu, Xu, Xu, Xu, Xu, Xu, Xu, Xu, Xu, Xu, Xu, Xu^Zos, Xu^Zos, Xos^Zos, Xos^Zos, Urb, Urb, Urb, Xol, Xol, Xos, Xos, Xu, Xu, Xu, Xu, Xu, Xu, Xu, Xu, Xu, Xu, Xu, Xu, Xu, Xu, Xu, Wog, Wog, Xu, Xu, Xu, Xu
Xu, Xu, Xu, Xu, Xu, Xu, Xu, Xu, Xu, Xu, Xu, Xu, Xu, Xu, Xu, Xu, Xu, Xu, Xu^Zos, Xu^Zos, Xos, Xos, Urb, Urb, Urb, Urb, Cud, Xos, Xos, Xos, Xu, Xu, Xu, Xu, Xu, Xu, Xu, Xu, Xu, Xu, Xu, Xu, Wog, Wog, Xu, Xu, Xu, Xu, Xu, Xu
Xu, Xu, Xu, Xu, Xu, Xu, Xu, Xu, Xu, Xu, Xu, Xu, Xu, Xu, Qxu, Xu, Xu, Xu, Xu, Xu, Xu, Xos, Xos, Urb, Cud, Kud, Rr, Urb, Urb, Xos, Xu, Xu, Xu, Xu, Xu, Xu, Xu, Xu, Xu, Xu, Wog, Wog, Xu, Xu, Xu, Xu, Xu, Xu, Xu, Xu
Xu, Xu, Xu, Xu, Xu, Xu, Xos, Xos, Xos, Xu, Xu, Xu, Qxu, Qxu, Qxu, Qxu, Qxu, Qxu, Qxu, Qxu, Qxu, Xu, Xu, Xos, Xos, Urb, Urb, Rr, Urb, Xos, Xu, Xu, Xu, Xu, Xu, Xu, Xu, Xu, Wog, Wog, Xu, Xu, Xu, Xu, Xu, Xu, Xu, Xu, Xu, Xu
Xu, Xu, Xu, Xu, Xos, Xos, Xos, Xos, Urb, Xos, Xos, Qxu, Xos, Qxu, Qxu, Qxu, Qxu, Qxu, Xos, Qxu, Xu, Qxu, Xu, Xu, Xos, Xos, Urb, Rr, Urb, Xos, Xu, Xu, Xu, Xu, Xu, Xu, Xu, Xu, Wog^Xo, Xu, Xu, Xu, Xu, Xu, Xu, Xu, Xu, Xu, Xu, Xu
Xu, Xu, Xos, Xos, Xos, Xos, Urb, Urb, Uu, Uu, Xos, Xos, Xol, Qxu, Qxu, Qxu, Qxu, Xol, Xos, Xol, Xu, Qxu, Qxu, Qxu, Xos, Xos, Urb, Rr, Urb, Xos, Qxu, Qxu, Qxu, Xu, Xu, Xu, Xu, Xu, Wog, Wog, Wog, Xu, Xu, Xu, Xu, Xu, Xu, Xu, Xu, Xu
Xu, Xu, Xu, Xos, Xos, Urb, Urb, Urb, Urb, Urb, Urb, Xol, Cud, Cud, 2 Kud, Cud, Cud, Xos, Xu, Xu, Xu, Qxu, Qxu, Qxu, Xos, Xos, Urb, Rr, Urb, Qxu, Qxu, Qxu, Xu, Xu, Xu, Xu, Qxu, Qxu, Qxu, Wog, Wog, Wog, Xu, Xu, Xu, Xu, Xu, Xu, Xu, Xu
Xu, Xu, Xu, Xu, Xu, Xos, Xos, Xos, Xol, Urb, Urb, Urb, Urb, Cud, Urb, Cud, Urb, Urb, Cud, Xu, Xu, Xu, Xu, Xos, Xos, Xos, Urb, Rr, Urb, Qxu, Xos, Xu, Xu, Xu, Xol, Xu, Uu, Qxu, Qxu, Xu, Wog, Wog, Xu, Xu, Xu, Xu, Xu, Xu, Xu, Xu
Xu, Xu, Xu, Xu, Xu, Xu, Xu, Xu, Urb^Bzl, Urb, Urb, Urb, Urb, Urb, Urb, Urb, Urb, Urb, Cud, Xu, Xu, Xu, Xu, Xos, Xos, Xos, Urb, Rr, Urb, Qxu, Xos, Xu, Xu, Xol, Uh^Uf, Uh^Uf, Uu, Uu, Urb, Xos, Wog, Wog, Wog, Xu, Xu, Xu, Xu, Xu, Xu, Xu
Xu, Xu, Xu, Xu, Xu, Xu, Xu, Xu, Urb, Urb, Urb, Urb, Xos, Urb, Urb, Urb, Urb, Urb, Xos, Xos, Xu, Xu, Xos, Xos, Xol, Xos, Urb^Ngl\, Rr, Urb, Xos, Xos, Qxu, Kud, Cud, Uu, Uh, Uu, Urb, Uu, Uu, Uu^Uf, Wog, Wog, Wog, Wog, Xu, Xu, Xu, Xu, Xu
Xu, Xu, Xu, Xu, Xu, Xu, Xuc, Xuc, Xuc, Xu, Xos, Xos, Xol, Xos, Urb, Rr, Urb, Xos, Xos, Xu, Xos, Xos, Xos, Xol, Urb, Urb, Rr, Rr^Ngl\, Urb^Ngl\, Xos, Xos, Qxu, Cud, Uu, Urb, Urb, Urb, Urb, Urb, Uu^Uf, Uu^Uf, Xos, Xu, Wog, Wog, Wog, Wog, Xu, Xu, Xu
Xu, Ql, Uu, Xu, Qxu, Xu, Xuc, Xuc, Iwr, Xuc, Cud, Urb, Urb, Xol, Urb, Rr, Urb, Xos, Xos, Xos, Xol, Xol, Xos, Urb, Rr, Rr, Urb, Urb, Xos, Xos, Xos, Xos, Uh^Uf, Uu^Uf, Uu, Urb, Urb, Urb, Uu, Uu, Cud, Xos, Xos, Xos, Qxu, Wog, Wog^Xo, Xu, Xu, Xu
Qlf, Ql, Ql, Qxu, Ql, Qxu, Qxu, Iwr, Iwr^Ii, Iwr, Xos, Xos, Xos, Urb, Rr, Rr, Urb, Xos, Xol, Xos, Xos, Xos, Xos, Urb, Rr, Urb, Xos, Xos, Xos, Xos, Xos, Xos, Xos, Uh^Uf, Urb, Urb, Urb, Urb, Urb, Urb, Xol, Xol, Qxu, Qxu^Xo, Xu, Xu, Wog, Xu, Xu, Xu
Xu, Xu, Xu, Xu, Qxu, Qxu, Xuc, Iwr, Iwr, Iwr, Xuc, Xos, Qxu, Urb, Rr, Urb, Xos, Xol, Xos^Zos, Xos^Zos, Xos^Zos, Xos, Xos, Urb, Rr, Urb, Xos, Xos, Xos, Xos, Xol, Xos, Urb, Urb, Urb, Urb, Xos, Urb, Urb^Ng/, Urb^Ng/, Urb, Uu, Uu, Xu, Xu, Xu, Xu, Wog, Wog, Xu
Xu, Xu, Qxu, Qlf, Qxu, Qxu, Xos, Xuc, Xuc, Xuc, Xu, Qxu, Qxu, Urb, Rr, Urb, Xos, Xos, Urb, Urb^Zos, Urb^Zos, Xos^Zos, Xos, Urb, Rr, Urb, Xol, Xos, Xos, Xol, Urb, Urb, Urb, Urb, Xos, Xol, Xu, Xos, Urb, Ur, Urb, Urb, Urb, Uu^Uf, Xos, Xu, Xu, Xu, Xu, Wog
Xu, Xu, Ql, Qxu, Qlf, Xu, Xu, Xu, Xu, Xu, Xos, Xos, Urb, Urb, Rr, Urb, Urb, Urb^Ngl\, Urb^Ngl\, Urb, Xol, Xos, Qxu, Urb, Rr, Urb, Urb, Xol, Urb^Xo, Urb, Urb, Urb, Xos, Xos, Xu, Xu, Urb, Ur, Ur, Ur, Ur, Urb, Cud, Uu^Uf, Xos, Xu, Xu, Xu, Xu, Xu
Qlf, Qlf, Ql, Ql, Qxu, Xu, Qxu, Xu, Xu, Xos, Urb, Cud, Kud, Rr, Urb, Rr, Rr, Urb, Urb, Xol, Xol, Xos, Qxu, Urb, Urb, Rr, Rr, Urb, Urb, Urb^Xo, Xos, Xos, Xos, Xu, Xu, Urb, Urb, Ur, Urb, Ur, Cud, Urb^Bzl, 3 Kud, Cud, Xos, Xu, Xu, Xu, Xu, Xu
Xu, Xu, Qxu, Xu, Qxu, Qlf, Cud, Cud, Urb, Urb, Rr, Rr, Urb, Cud, Xos, Urb, Urb, Rr, Rr, Urb, Urb, Qxu, Qxu, Qxu, Xos, Urb, Urb, Rr, Urb, Xos, Xos, Xos, Xos^Zos, Xos, Xu, Urb, Urb, Urb, Xos, Cud, Qxu, Cud, Cud, Cud, Xos, Xu, Xu, Xu, Xu, Xu
Xu, Xu, Qxu, Qxu, Cud, Cud, Urb, Urb, Rr, Rr, Urb, Urb, Xos, Xos, Xu, Xos, Xos, Urb, Urb, Rr, Rr, Urb, Urb, Xos, Xol, Xos, Urb, Rr, Urb, Xos, Xos^Zos, Xos^Zos, Qxu^Zos, Xos^Zos, Xos^Zos, Xu, Xu, Xu, Xos, Cud, Cud, Cud, Xos, Xos, Xu, Xu, Xu, Xu, Xu, Xu
Xos, Qxu, Xos, Xos, Urb, Urb, Rr, Rr, Urb, Urb, Xos, Xos, Xu, Xu, Xu, Xu, Xu, Xos, Xos, Urb, Urb, Rr, Rr, Urb, Urb, Xol, Urb, Rr, Urb, Xos, Qxu, Qxu^Zos, Qxu^Zos, Qxu^Zos, Qxu^Zos, Xos^Zos, Xos^Zos, Xu, Xos, Xos, Xos, Xos, Xu, Xu, Xu, Xu, Xu, Xu, Xu, Xu
Xos, Xos, Urb, Urb^Ngl\, Rr^Ngl\, Rr, Urb, Urb, Xos, Xos, Xu, Xu, Xu, Xu, Xu, Xu, Xu, Xu, Xol, Xos, Urb, Urb, Rr, Rr, Rr, Urb^Xo, Rr, Rr, Urb, Cud, Cud, Qxu, Qxu, Qxu^Zos, Qxu^Zos, Qxu^Zos, Qxu^Zos, Xos^Zos, Xos^Zos, Xos, Xu, Xu, Xu, Xu, Xu, Xu, Xu, Xu, Xu, Xu
Urb, Urb, Rr, Rr, Urb, Urb^Ngl\, Xos, Xos, Xu, Xu, Xu, Xu, Xu, Xu, Xu, Xu, Xu, Xol, Cud, Urb, Rr, Rr, Urb, Urb, Xos, Rr^Xo, Urb, Urb, Urb, Urb, Urb, Cud, Cud, Qxu, Qxu, Qxu^Zos, Qxu^Zos, Qxu^Zos, Xos^Zos, Xos^Zos, Xos, Xu, Xu, Xu, Xu, Xu, Xu, Xu, Xu, Xu
Rr, Rr, Urb, Urb, Xos, Xos, Xu, Xu, Xu, Xu, Xu, Xu, Xu, Xu, Xu, Xu, Xu, Urb, Urb, Kud, Cud, Urb, Xos, Xos, Qxu, Qxu, Qxu, Urb, Urb, Urb, Urb, Urb, Urb, Cud, Cud, Qxu, Xos, Xos^Zos, Xos, Xos, Xos, Xu, Xu, Xu, Xu, Xu, Xu, Xu, Xu, Xu
Urb, Urb, Urb, Xos, Iwr, Xos, Xos, Xu, Xu, Xu, Xos, Xos, Xos, Xu, Cud, Xu, Urb, Urb, Urb, Urb, Xos, Xos, Xos, Xos, Xos, Qxu, Qxu, Qxu, Xos, Urb, Urb, Urb, Urb, Urb, Xol, Xos, Xos, Xos, Xu, Xos, Xos, Xos, Xos, Xu, Xu, Xu, Xu, Xu, Xu, Xu
Xos, Xos, Xos, Iwr, Iwr^Ii, Iwr, Xos, Xu, Xu, Xos, Xu, Xu, Urb, Xu, Urb, Urb, Urb, Urb, Xu, Xu, Xu, Xos, Xos, Xos, Xos, Xos, Xol, Xos, Urb, Xos, Urb^Ng\, Urb, Urb, Urb, Urb^Ng/, Xol, Xu, Xu, Xu, Xu, Qxu, Xos, Xos, Xos, Xos, Xu, Xu, Xu, Xu, Xu
Xu, Xu, Xos, Iwr, Iwr, Iwr, Xos, Xu, Xu, Xos, Urb, Urb, Cud, Urb, Urb, Urb, Urb, Urb, Cud, Xu, Xu, Xos, Xos, Xos, Xos, Xol, Urb, Urb, Urb, Urb, Urb, Urb^Ng\, Xos, Urb^Ng/, Urb, Urb^Bzn, Urb, Uue, Uue, Uh^Uf, Uh, Qxu, Xu, Xos, Xos, Xu, Xu, Xu, Xu, Xu
Xu, Xu, Xu, Xos, Xos, Xos, Xu, Xu, Xu, Xos, Urb, Cud, Kud, Cud, Urb^Bzl, Urb, Urb, Urb, Urb, Xu, Xos, Xos, Xos, Xos, Xos, Urb, Urb, Urb, Urb, Urb, Xos, Xos, Xu, Urb^Bzn, Urb, Urb, Urb, Urb, Ur, Uh, Ur, Qxu, Xu, Xos, Xos, Xu, Xu, Xu, Xu, Xu
Xu, Xu, Xu, Xu, Xu, Xu, Xu, Xu, Xos, Xos, Urb, Cud, Cud, Cud, Urb, Urb, Urb, Urb, Urb^Ng/, Xos, Urb^Ng\, Uu, Uu, Xos, Xos, Urb, Urb, Urb, Urb, Xos, Xu, Xu, Uu, Urb, Urb, Urb, Urb, 1 Urb, Urb, Urb, Ur, Ur, Xos, Xos, Xos, Xu, Xu, Xu, Xu, Xu
Xu, Xu, Xu, Xu, Xu, Xu, Xos, Xos, Xos, Xos, Urb, Urb, Urb, Urb, Xos, Xos, Xos, Urb^Ng/, Urb, Urb, Urb, Urb^Ng\, Xos, Xos, Urb, Xol, Xol, Urb, Xos, Xos, Uhe^Uf, Uue, Uu, Urb, Ur, Urb, Urb, Urb, Urb, Uue, Uu, Uu, Xos, Xos, Xu, Xu, Xu, Xu, Xu, Xu
Xu, Xu, Xu, Xu, Xu, Xu, Xos, Xos, Xu, Xos, Xos, Qxu, Xu, Xos, Urb, Uu, Uu, Urb^Ng\, Urb^Ng\, Urb, Ur, Urb, Urb, Urb^Ng\, Urb^Ng\, Urb, Xol, Xos, Xu, Xos, Xos, Uhe, Uhe, Uue, Uue, Ur, Uu, Uu, Uu, Uu, Uue, Xu, Xu, Xu, Xu, Xu, Xu, Xu, Xu, Xu
Xu, Xu, Xu, Xu, Xu, Xos, Xu, Xu, Xuc, Xu, Qxu, Qxu, Xu, Xos, Xos, Urb, Uu, Urb, Xos, Xos, Urb^Ng\, Ur, Ur, Urb, Urb, Xos, Xol, Xol, Xu, Xu, Qxe, Uhe, Urb, Uue, Urb, Uu, Uh^Uf, Uh, Uh, Urb, Qxu, Xu, Xu, Xu, Xu, Xu, Xu, Xu, Xu, Xu
Xu, Xu, Xu, Xu, Xu, Xu, Qxu, Xu, Qxu, Qxu, Qxu, Qxu, Xu, Xu, Xu, Xos, Xos, Xos, Uu^Uf, Urb, Urb, Urb^Ng\, Xos, Urb, Urb^Ng/, Urb^Ng/, Urb^Bzn, Uh, Uh, Xu, Qxe, Qxe, Qxe, Qxe, Xu, Xu, Xos, Uh^Uf, Xos, Qxu, Qxu, Qxu, Xu, Xu, Xu, Xu, Xu, Xu, Xu, Xu
Xu, Xu, Xu, Xu, Xu, Qxu, Qxu, Qxu, Qxu, Qxu, Qxu, Xuc, Xuc, Xu, Qxu, Xos, Xos, Uu^Uf, Uu^Uf, Urb, Urb, Xos, Xol, Xol, Urb^Bzn, Urb, Ur, Urb, Urb, Uue, Qxe, Qxe, Qxe, Xu, Xu, Xu, Xu, Xos, Xos, Xos, Qxu, Qxu, Qxu, Xu, Xu, Xu, Xu, Xu, Xu, Xu
Xu, Xu, Xu, Xu, Xu, Xu, Xos, Qxu, Xos, Xos, Xos, Qxu, Qxu, Qxu, Qxu, Qxu, Uu^Ngl/, Xos, Qxu, Uu, Xos, Xos, Xu, Urb, Uu, Urb, Ur, Uu, Urb, Uue, Urb^Uf, Qxe, Xu, Xu, Xu, Xu, Xu, Xu, Xu, Xu, Xu, Qxu, Qxu^Xo, Xu, Xu, Xu, Xu, Xu, Xu, Xu
Xu, Xu, Xu, Xu, Xu, Xu, Xu, Xos, Xos, Xos, Xos, Xos, Xos, Xu, Xu, Xos, Xos, Qxu, Qxu, Qxu, Uu^Ngl/, Xos, Urb^Uf, Uu, Uu, Urb, Uh, Urb, Urb, Urb, Xos, Qxe, Xu, Xu, Xu, Xu, Xu, Xu, Xu, Xu, Xu, Xu, Xu, Qxu, Qxu, Xu, Xu, Xu, Xu, Xu
Xu, Xu, Xu, Xu, Xu, Xu, Xu, Xu, Xu, Xos, Xos, Xos, Xu, Xu, Xu, Xos, Xos, Xos, Xos, Xos, Qxu, Qxu, Qxu, Uh, Uh, Uh, Uu^Uf, Uh^Uf, Uh^Uf, Uh, Xos, Xu, Xu, Xu, Xu, Xu, Xu, Xu, Xu, Xu, Xu, Xu, Xu, Qxu, Qxu, Xu, Xu, Xu, Xu, Xu
Xu, Xu, Xu, Xu, Xu, Xu, Xu, Xu, Xu, Xu, Xu, Xu, Xu, Xu, Xu, Xu, Xu, Xu, Xu, Xu, Qxu, Qxu, Qxu, Qxu, Qxu, Qxu, Xu, Xos, Xos, Xos, Xu, Xu, Xu, Xu, Xu, Xu, Xu, Xu, Xu, Xu, Xu, Xu, Xu, Qxu, Qxu, Xu, Xu, Xu, Xu, Xu
Xu, Xu, Xu, Xu, Xu, Xu, Xu, Xu, Xu, Xu, Xu, Xu, Xu, Xu, Xu, Xu, Xu, Xu, Xu, Xu, Xu, Qxu, Qxu, Qxu, Xu, Xu, Xu, Xu, Xu, Xu, Xu, Xu, Xu, Xu, Xu, Xu, Xu, Xu, Xu, Xu, Xu, Xu, Xu, Xu, Xu, Xu, Xu, Xu, Xu, Xu
Xu, Xu, Xu, Xu, Xu, Xu, Xu, Xu, Xu, Xu, Xu, Xu, Xu, Xu, Xu, Xu, Xu, Xu, Xu, Xu, Xu, Xu, Xu, Xu, Xu, Xu, Xu, Xu, Xu, Xu, Xu, Xu, Xu, Xu, Xu, Xu, Xu, Xu, Xu, Xu, Xu, Xu, Xu, Xu, Xu, Xu, Xu, Xu, Xu, Xu
Xu, Xu, Xu, Xu, Xu, Xu, Xu, Xu, Xu, Xu, Xu, Xu, Xu, Xu, Xu, Xu, Xu, Xu, Xu, Xu, Xu, Xu, Xu, Xu, Xu, Xu, Xu, Xu, Xu, Xu, Xu, Xu, Xu, Xu, Xu, Xu, Xu, Xu, Xu, Xu, Xu, Xu, Xu, Xu, Xu, Xu, Xu, Xu, Xu, Xu
Xu, Xu, Xu, Xu, Xu, Xu, Xu, Xu, Xu, Xu, Xu, Xu, Xu, Xu, Xu, Xu, Xu, Xu, Xu, Xu, Xu, Xu, Xu, Xu, Xu, Xu, Xu, Xu, Xu, Xu, Xu, Xu, Xu, Xu, Xu, Xu, Xu, Xu, Xu, Xu, Xu, Xu, Xu, Xu, Xu, Xu, Xu, Xu, Xu, Xu
Xu, Xu, Xu, Xu, Xu, Xu, Xu, Xu, Xu, Xu, Xu, Xu, Xu, Xu, Xu, Xu, Xu, Xu, Xu, Xu, Xu, Xu, Xu, Xu, Xu, Xu, Xu, Xu, Xu, Xu, Xu, Xu, Xu, Xu, Xu, Xu, Xu, Xu, Xu, Xu, Xu, Xu, Xu, Xu, Xu, Xu, Xu, Xu, Xu, Xu
