border_size=1
usage=map

Xu, Xu, Xu, Xu, Xu, Xu, Xu, Xu, Xu, Xu, Xu, Xu, Xu, Xu, Xu, Xu, Xu, Xu, Xu, Xu^Zos, Xos^Zos, Xos^Zos, Urb^Zos, Urb^Zos, Urb^Zos, Xos^Zos, Xos^Zos, Xu^Zos, Xu, Xu, Xu, Xu, Xu, Xu, Xu, Xu, Xu, Xu, Xu, Xu, Xu, Xu, Xu, Xu, Xu, Xu, Xu, Xu, Xu, Xu
Xu, Xu, Xu, Xu, Xu, Xu, Xu, Xu, Xu, Xu, Xu, Xu, Xu, Xu, Xu, Xu, Xu, Xu, Xu, Xu^Zos, Xos^Zos, Xos^Zos, Urb^Zos, Urb^Zos, Urb^Zos, Xos^Zos, Xos^Zos, Xu^Zos, Xu, Xu, Xu, Xu, Xu, Xu, Xu, Xu, Xu, Xu, Xu, Xu, Xu, Xu, Xu, Xu, Xu, Xu, Xu, Xu, Xu, Xu
Xu, Xu, Xu, Xu, Xu, Xu, Xu, Xu, Xu, Xu, Xu, Xu, Xu, Xu, Xu, Xu, Xu, Xu, Xu, Xu^Zos, Xos^Zos, Xos^Zos, Urb^Zos, Urb^Zos, Urb^Zos, Xos^Zos, Xos^Zos, Xu^Zos, Xu, Xu, Xu, Xu, Xu, Xu, Xu, Xu, Xu, Xu, Xu, Xu, Xu, Xu, Xu, Xu, Xu, Xu, Xu, Xu, Xu, Xu
Xu, Xu, Xu, Xu, Xu, Xu, Xu, Xu, Xu, Xu, Xu, Xu, Xu, Xu, Xu, Xu, Xu, Xu, Xu, Xu^Zos, Xos^Zos, Xos^Zos, Urb^Zos, Urb^Zos, Urb^Zos, Xos^Zos, Xos, Xu, Xu, Xu, Xu, Xu, Xu, Xu, Xu, Xu, Xu, Xu, Xu, Xu, Xu, Xu, Xu, Xu, Xu, Xu, Xu, Xu, Xu, Xu
Xu, Xu, Xu, Xu, Xu, Xu, Xu, Xu, Xu, Xu, Xu, Xu, Xu, Xu, Xu, Xu, Xu, Xu, Xu, Xu^Zos, Xos^Zos, Xos^Zos, Urb^Zos, Urb^Zos, Urb, Xos, Xos, Xu, Xu, Xu, Xu, Xu, Xu, Xu, Xu, Xu, Xu, Xu, Xu, Xu, Xu, Xu, Xu, Xu, Xu, Wog, Xu, Xu, Xu, Xu
Xu, Xu, Xu, Xu, Xu, Xu, Xu, Xu, Xu, Xu, Xu, Xu, Xu, Xu, Xu, Xu, Xu, Xu, Xu, Xu^Zos, Xos^Zos, Xos^Zos, Urb, Urb, Urb, Xol, Xol, Xos, Xos, Xu, Xu, Xu, Xu, Xu, Xu, Xu, Xu, Xu, Xu, Xu, Xu, Xu, Xu, Xu, Wog, Wog, Xu, Xu, Xu, Xu
Xu, Xu, Xu, Xu, Xu, Xu, Xu, Xu, Xu, Xu, Xu, Xu, Xu, Xu, Xu, Xu, Xu, Xu, Xu, Xu^Zos, Xos, Xos, Urb, Urb, Urb, Urb, Cud, Xos, Xos, Xos, Xu, Xu, Xu, Xu, Xu, Xu, Xu, Xu, Xu, Xu, Xu, Xu, Wog, Wog, Xu, Xu, Xu, Xu, Xu, Xu
Xu, Xu, Xu, Xu, Xu, Xu, Xu, Xu, Xu, Xu, Xu, Xu, Xu, Xu, Qxu, Xu, Xu, Xu, Xu, Xu, Xu, Xos, Xos, Urb, Cud, Kud, Rr, Urb, Urb, Xos, Xu, Xu, Xu, Xu, Xu, Xu, Xu, Xu, Xu, Xu, Wog, Wog, Xu, Xu, Xu, Xu, Xu, Xu, Xu, Xu
Xu, Xu, Xu, Xu, Xu, Xu, Xos, Xos, Xos, Xu, Xu, Xu, Qxu, Qxu, Qxu, Qxu, Qxu, Qxu, Qxu, Qxu, Xu, Xu, Xu, Xos, Xos, Urb, Urb, Rr, Urb, Xos, Xu, Xu, Xu, Xu, Xu, Xu, Xu, Xu, Wog, Wog, Xu, Xu, Xu, Xu, Xu, Xu, Xu, Xu, Xu, Xu
Xu, Xu, Xu, Xu, Xos, Xos, Xos, Xos, Uu, Xos, Xos, Qxu, Xos, Qxu, Qxu, Qxu, Qxu, Qxu, Xos, Qxu, Xu, Xu, Xu, Xu, Xos, Xos, Urb, Rr, Urb, Xos, Xu, Xu, Xu, Xu, Xu, Xu, Xu, Xu, Wog^Xo, Xu, Xu, Xu, Xu, Xu, Xu, Xu, Xu, Xu, Xu, Xu
Xu, Xu, Xos, Xos, Xos, Xos, Urb, Urb, Uu, Uu, Xos, Xos, Xol, Qxu, Qxu, Qxu, Qxu, Xol, Xos, Xol, Xu, Xu, Xu, Xu, Xos, Xos, Urb, Rr, Urb, Xos, Qxu, Qxu, Qxu, Xu, Xu, Xu, Xu, Xu, Wog, Wog, Wog, Xu, Xu, Xu, Xu, Xu, Xu, Xu, Xu, Xu
Xu, Xu, Xu, Xos, Xos, Urb, Uu, Urb, Urb^Ng/, Urb^Ng/, Urb, Xol, Cud, Cud, 2 Kud, Cud, Cud, Xos, Xu, Xu, Xu, Xu, Xu, Xu, Xos, Xos, Urb, Rr, Urb, Qxu, Qxu, Qxu, Xu, Xu, Xu, Xu, Qxu, Qxu, Qxu, Wog, Wog, Wog, Xu, Xu, Xu, Xu, Xu, Xu, Xu, Xu
Xu, Xu, Xu, Xu, Xu, Xos, Xos, Xos, Xol, Urb, Urb, Urb, Urb, Cud, Urb, Cud, Urb, Urb, Cud, Xu, Xu, Xu, Xu, Xu, Xos, Xos, Urb, Rr, Urb, Qxu, Xos, Xu, Xu, Xu, Xol, Xu, Uh, Qxu, Qxu, Xu, Wog, Wog, Xu, Xu, Xu, Xu, Xu, Xu, Xu, Xu
Xu, Xu, Xu, Xu, Xu, Xu, Xu, Xu, Urb^Bzl, Urb, Urb, Urb, Urb, Urb, Urb, Urb, Urb, Urb, Cud, Xu, Xu, Xu, Xu, Xu, Xos, Xos, Urb, Rr, Urb, Qxu, Xos, Xu, Xu, Xol, Uh^Uf, Uh^Uf, Uu^Es, Uu^Es, Ur, Xos, Wog, Wog, Wog, Xu, Xu, Xu, Xu, Xu, Xu, Xu
Xu, Xu, Xu, Xu, Xu, Xu, Xu, Xu, Urb, Urb, Urb, Urb, Xos, Urb, Urb, Urb, Urb, Urb, Xos, Xu, Xu, Xu, Xos, Xos, Xos, Xos, Urb, Rr, Urb, Xos, Xos, Qxu, Cud, Cud, Uu, Uh, Uu, Ur, Uu, Uu^Em, Uu^Uf, Wog, Wog, Wog, Wog, Xu, Xu, Xu, Xu, Xu
Xu, Xu, Xu, Xu, Xu, Xu, Xuc, Xuc, Xuc, Xu, Xos, Xos, Xos, Xos, Urb, Rr, Urb, Xos, Xu, Xu, Xos, Xos, Xol, Xol, Urb, Urb^Ngl\, Rr^Ngl\, Rr, Urb, Xos, Xos, Qxu, Cud, Uu, Ur^Es, Ur, Urb^Ii, Urb, Urb, Uu^Uf, Uu^Uf, Xos, Xu, Wog, Wog, Wog, Wog, Xu, Xu, Xu
Xu, Ql, Uu, Xu, Qxl, Xu, Xuc, Xuc, Iwr, Xuc, Cud, Urb, Urb^Ng/, Xos, Urb, Rr, Urb, Xos, Xu, Xu, Xol, Xos, Urb, Urb, Rr, Rr, Urb, Urb^Ngl\, Xos, Xos, Xos, Xos, Uh^Uf, Uu^Uf, Uu, Urb, Urb, Urb^Es, Uu, Uu, Cud, Xos, Xos, Xos, Qxu, Wog, Wog^Xo, Xu, Xu, Xu
Qlf, Ql, Ql, Qxl, Ql, Qxl, Qxl, Iwr, Iwr^Ii, Iwr, Xos, Xos, Xos, Urb, Rr, Rr, Urb, Xos, Xu, Xu, Xos, Xos, Urb, Rr, Urb, Urb, Xuc, Xos, Xos, Xos, Xos, Xos, Urb, Uh^Uf, Urb, Urb, Urb, Urb, Urb, Urb, Xol, Xol, Qxu, Qxu^Xo, Xu, Xu, Wog, Xu, Xu, Xu
Xu, Xu, Xu, Xu, Qxl, Qxl, Xuc, Iwr, Iwr, Iwr, Xuc, Xos, Qxu, Urb, Rr, Urb, Xol, Xos, Xu, Xu, Xu, Xos, Urb, Rr, Urb, Xuc, Cud, Xuc, Xuc, Xos, Cud, Urb, Urb, Urb, Urb, Urb, Xos, Urb, Urb, Urb, Urb, Uu, Uu, Xu, Xu, Xu, Xu, Wog, Wog, Xu
Xu, Xu, Qxl, Qlf, Qxl, Ql, Qxl, Xuc, Xuc, Xuc, Xu, Qxu, Qxu, Urb, Rr, Urb, Xos, Xu, Xu, Xu, Xuc, Xuc, Urb^Bzl, Rr, Rr, Urb, Urb, Xuc, Urb, Urb, Rr, Cud, Cud, Urb, Xos, Xol, Xuc, Xos, Urb, Ur, Urb, Urb, Urb, Uu^Uf, Xos, Xu, Xu, Xu, Xu, Wog
Xu, Xu, Ql, Qxl, Qlf, Qlf, Qxl, Xu, Xu, Xu, Xol, Xol, Urb, Urb, Rr, Urb, Urb, Xol, Xol, Xu, Xu, Xuc, Cud, Urb, Urb, Rr, Rr, Urb, Rr, Rr, Urb, Urb, Xu, Xu, Xuc, Xuc, Urb, Ur, Ur, Ur, Ur, Urb, Cud, Uu^Uf, Xos, Xu, Xu, Xu, Xu, Xu
Qlf, Qlf, Ql, Ql, Ql, Qxl, Qxl, Qxl, Xu, Xos, Urb, Cud, Kud, Rr, Urb, Rr, Rr, Urb, Urb, Xos, Xos, Xuc, Xu, Xuc, Xos, Urb, Urb, Rr, Rr, Rr, Urb, Xuc, Xuc, Xu, Xuc, Urb, Urb, Ur, Urb, Ur, Cud, Urb^Bzl, 3 Kud, Cud, Xos, Xu, Xu, Xu, Xu, Xu
Xu, Xu, Qxl, Qxl, Qxl, Qlf, Cud, Cud, Urb, Urb, Rr, Rr, Urb, Cud, Xos, Urb, Urb, Rr, Rr, Urb, Urb, Xu, Xu, Xuc, Xu, Xos, Xu, Urb, Rr, Rr, Urb, Cud, Xuc, Xu, Xuc, Urb, Urb, Urb, Xos, Cud, Qxu, Cud, Cud, Cud, Xos, Xu, Xu, Xu, Xu, Xu
Xu, Xu, Qxl, Qxl, Cud, Cud, Urb, Urb, Rr, Rr, Urb, Urb, Xos, Xos, Xu, Xos, Xos, Urb, Urb, Rr, Rr, Urb, Urb, Cud, Urb, Xu, Urb, Urb, Rr, Rr, Urb, Cud, Xuc, Xuc, Xu^Zos, Xu, Xu, Xuc, Xos, Cud, Cud, Cud, Xos, Xos, Xu, Xu, Xu, Xu, Xu, Xu
Xos, Xos, Xol, Xos, Urb, Urb, Rr, Rr, Urb, Urb, Xos, Xos, Xu, Xu, Xu, Xu, Xu, Xos, Xos, Urb, Urb, Rr, Rr, Urb, Rr, Urb, Rr, Rr, Urb, Urb, Xuc, Xuc, Xu^Zos, Xu^Zos, Xos^Zos, Xu^Zos, Xu^Zos, Xuc, Xuc, Xos, Xos, Xos, Xu, Xu, Xu, Xu, Xu, Xu, Xu, Xu
Urb, Xol, Urb^Ngl\, Urb, Rr, Rr, Urb, Urb, Xos, Xos, Xu, Xu, Xu, Xu, Xu, Xu, Xu, Xu, Xol, Xos, Urb, Urb, Rr, Rr, Urb, Rr, Rr, Rr, Urb, Xol, Xol, Xos, Qxu, Qxu^Zos, Qxu^Zos, Xos^Zos, Xos^Zos, Xu^Zos, Xu^Zos, Xuc, Xu, Xu, Xu, Xu, Xu, Xu, Xu, Xu, Xu, Xu
Rr, Urb, Rr, Rr^Ngl\, Urb^Ngl\, Urb, Xos, Xos, Xu, Xu, Xu, Xu, Xu, Xu, Xu, Xu, Xuc, Xol, Cud, Urb, Rr, Rr, Urb, Urb, Cud, Urb, Urb, Urb, Urb, Urb, Cud, Qxu, Qxu, Qxu, Qxu, Qxu^Zos, Qxu^Zos, Xos^Zos, Xos^Zos, Xu^Zos, Xu^Zos, Xu, Xu, Xu, Xu, Xu, Xu, Xu, Xu, Xu
Rr, Rr, Rr, Urb, Xos, Xos, Xu, Xu, Xu, Xu, Xu, Xu, Xu, Xu, Xuc, Xu, Xuc, Urb^Bzl, Urb, Cud, Cud, Urb, Xos, Xos, Xos, Xos, Qxu, Urb, Urb, Urb, Urb, Cud, Cud, Qxu, Qxu, Qxu, Qxu, Qxu^Zos, Qxu^Zos, Xos^Zos, Xos^Zos, Xu^Zos, Xu, Xu, Xu, Xu, Xu, Xu, Xu, Xu
Rr, Rr, Urb, Urb, Xos, Xu, Xu, Xu, Xu, Xu, Xos, Xos, Xos, Xuc, Cud, Xuc, Urb, Urb, Urb, Urb, Xos, Xos, Xos^Zos, Xos^Zos, Qxu^Zos, Qxu, Qxu, Urb, Urb, Urb, Urb, Urb, Urb, Cud, Cud, Qxu, Qxu, Qxu, Xos, Xos^Zos, Xos, Xu, Xu, Xu, Xu, Xu, Xu, Xu, Xu, Xu
Urb, Urb, Cud, Cud, Xu, Xu, Xu, Xu, Xos, Xos, Xu, Xu, Urb, Xuc, Urb, Urb, Urb, Urb, Xuc, Xuc, Xu, Xu, Xu, Xos^Zos, Xos^Zos, Qxu^Zos, Qxu^Zos, Qxu, Qxu, Urb, Urb, Urb, Urb, Urb, Urb, Cud, Xos, Xos, Xos, Xos, Xos, Xos, Xos, Xu, Xu, Xu, Xu, Xu, Xu, Xu
Xos, Cud, Xu, Xu, Xu, Xu, Xu, Xu, Xos, Xos, Urb, Urb, Cud, Urb, Urb, Urb, Urb, Urb, Cud, Xuc, Xu, Xu, Xu, Xu, Xu, Xos^Zos, Xos^Zos, Qxu^Zos, Xos, Xos, Xos, Urb, Urb, Urb, Urb, Xol, Xol, Xos, Xu, Xu, Xu, Xos, Xos, Xos, Xos, Xu, Xu, Xu, Xu, Xu
Xos, Xos, Xu, Xu, Xu, Xu, Xu, Xu, Xos, Xos, Urb, Cud, 4 Kud, Cud, Urb^Bzl, Urb, Urb, Urb, Urb, Xuc, Xu, Xu, Xu, Xu, Xu, Xos, Xol, Xol, Urb, Urb, Urb, Urb^Ng\, Urb^Ng\, Urb, Urb^Ng/, Urb^Ng/, Urb^Bzn, Xu, Uue, Xu, Uh^Uf, Qxe, Qxe, Xos, Xos, Xos, Xu, Xu, Xu, Xu
Xu, Xu, Xu, Xu, Xu, Xu, Xu, Xu, Xos, Xos, Urb, Cud, Cud, Cud, Urb, Urb, Urb, Urb, Urb^Ng/, Xol, Xol, Xu, Xu, Xu, Xu, Xos, Urb, Urb, Urb, Urb, Urb, Urb, Xos, Xos, Urb^Bzn, Urb, Urb, Urb, Urb, Uue, Uh, Uh, Qxe, Xu, Xos, Xos, Xu, Xu, Xu, Xu
Xu, Xu, Xu, Xu, Xu, Xu, Xu, Xu, Xos, Xos, Urb, Urb, Urb, Urb, Urb, Urb, Urb^Ng/, Urb^Ng/, Urb, Urb, Urb, Xu, Xu, Xu, Xos, Xos, Urb, Urb, Urb, Urb, Xos, Xos, Xu, Xu, Urb, Urb, Urb, Urb, 1 Urb, Ur, Urb, Ur, Ur, Xu, Xos, Xos, Xu, Xu, Xu, Xu
Xu, Xu, Xu, Xu, Xu, Xu, Xu, Xu, Xu, Xos, Xos, Qxu, Xu, Xos, Xos, Xos, Xos, Urb, Urb, Urb, Cud, Xu, Xos, Xos, Uh^Uf, Xos, Xos, Urb, Urb, Urb, Xos, Xu, Uue, Uu, Urb, Urb, Urb, Urb, Urb, Urb, Uue, Ur, Uu, Xos, Xos, Xos, Xu, Xu, Xu, Xu
Xu, Xu, Xu, Xu, Xu, Xu, Xu, Xu, Xuc, Xu, Qxu, Qxu, Xu, Xu, Xu, Xos, Xu, Xu, Cud, Cud, Urb, Xos, Xos, Uu^Uf, Urb^Edt, Urb^Edb, Uh, Xos, Xos, Xos, Xos, Uhe^Uf, Uhe, Uu, Uue, Ur, Ur, Urb, Uu, Urb, Uu, Uu, Xu, Xos, Xu, Xu, Xu, Xu, Xu, Xu
Xu, Xu, Xu, Xu, Xu, Xu, Uu, Xu, Qxu, Qxu, Qxu, Qxu, Xu, Xu, Xu, Xu, Xu, Xu, Urb, Rr, Urb, Xos, Urb^Ng\, Uu, Urb^Es, Uu^Es, Xos, Xos, Xu, Xu, Xu, Xos, Uhe, Uhe, Uue^Edt, Uue, Uu, Uu, Uh, Uu, Urb, Uue, Xu, Xu, Xu, Xu, Xu, Xu, Xu, Xu
Xu, Xu, Xu, Xu, Xu, Uu, Qxu, Qxu, Qxu, Qxu, Qxu, Xuc, Xuc, Xu, Xu, Xu, Qxu, Xu, Urb, Rr, Urb, Urb, Urb, Xos, Xol, Xos, Xuc, Xuc, Xuc, Xu, Xu, Qxe, Qxe, Urb, Qxe, Urb, Xu, Uh^Uf, Uh^Uf, Uh, Qxe, Qxe, Qxe, Xu, Xu, Xu, Xu, Xu, Xu, Xu
Xu, Xu, Xu, Xu, Xu, Uu, Xos, Qxu, Xos, Xos, Xos, Qxu, Qxu, Qxu, Qxu, Qxu, Qxu, Qxu, Urb^Bzu, Rr, Rr, Urb, Urb, Xol, Uh, Xuc, Uu^Bzu, Cud, Xuc, Xu, Xu, Qxe, Qxe, Qxe, Xu, Xu, Xu, Xos, Xos, Xos, Xos, Qxe, Qxu, Xu, Xu, Xu, Xu, Xu, Xu, Xu
Xu, Xu, Xu, Xu, Xu, Xu, Xu, Xos, Xos, Xos, Xos, Xos, Xos, Xu, Xu, Qxu, Xos, Qxu, Qxu, Urb, Urb, Rr, Rr, Urb, Urb^Es, Urb, Urb, Urb, Uu^Es, Xuc, Xuc, Qxe, Qxe, Qxe, Xu, Xu, Xu, Xu, Xu, Xos, Xu, Qxu, Qxu, Qxu, Xu, Xu, Xu, Xu, Xu, Xu
Xu, Xu, Xu, Xu, Xu, Xu, Xu, Xu, Xu, Xos, Xos, Xos, Xu, Xu, Xos, Qxu, Xos, Xos, Xos, Qxu, Urb, Urb, Rb, Rr, Cud^Es, Cud, Cud, Urb, Rb, Urb^Es, Xuc, Xuc, Xuc, Xu, Xu, Xu, Xu, Xu, Xu, Xu, Xu, Xu, Xu, Xu, Xu, Xu, Xu, Xu, Xu, Xu
Xu, Xu, Xu, Xu, Xu, Xu, Xu, Xu, Xu, Xu, Xu, Xu, Xu, Xu, Xos, Qxu, Wog, Xos, Xos, Cud, Uu, Uu^Es, Rb^Es, Urb, Cud, Kud, Cud, Uu^Es, Rb, Rb, Cud, Xos, Xos, Xu, Xu, Xu, Xu, Xu, Xu, Xu, Xu, Xu, Xu, Xu, Xu, Xu, Xu, Xu, Xu, Xu
Xu, Xu, Xu, Xu, Xu, Xu, Xu, Xu, Xu, Xu, Xu, Xu, Xu, Xu, Xos, Xos, Wog^Es, Wwrg, Wwf, Xol, Urb, Uu, Uu^Es, Rb, Urb, Cud, Urb, Uu, Uu^Bzl, Cud^Es, Cud, Xos, Xos, Xu, Xu, Xu, Xu, Xu, Xu, Xu, Xu, Xu, Xu, Xu, Xu, Xu, Xu, Xu, Xu, Xu
Xu, Xu, Xu, Xu, Xu, Xu, Xu, Xu, Xu, Xu, Xu, Xu, Xu, Xu, Xu, Xos, Wog, Wwf^Em, Uh^Uf, Uu^Uf, Uu, Urb, Uh, Urb, Urb, Urb, Urb, Urb, Xuc, Cud, Xos, Xos, Xos, Xu, Xu, Xu, Xu, Xu, Xu, Xu, Xu, Xu, Xu, Xu, Xu, Xu, Xu, Xu, Xu, Xu
Xu, Xu, Xu, Xu, Xu, Xu, Xu, Xu, Xu, Xu, Xu, Xu, Xu, Xu, Xu, Xu, Wog^Xo, Xu, Xu, Uh^Uf, Xuc, Uu, Xuc, Uu, Cud, Uu, Xuc, Xuc, Xuc, Xos, Xos, Xos, Xu, Xu, Xu, Xu, Xu, Xu, Xu, Xu, Xu, Xu, Xu, Xu, Xu, Xu, Xu, Xu, Xu, Xu
Xu, Xu, Xu, Xu, Xu, Xu, Xu, Xu, Xu, Xu, Xu, Xu, Xu, Xu, Wog, Wog, Xu, Xu, Xu, Xuc, Xu, Xuc, Xu, Xuc, Xuc, Xuc, Xu, Xu, Xu, Xos, Xu, Xu, Xu, Xu, Xu, Xu, Xu, Xu, Xu, Xu, Xu, Xu, Xu, Xu, Xu, Xu, Xu, Xu, Xu, Xu
Xu, Xu, Xu, Xu, Xu, Xu, Xu, Xu, Xu, Xu, Xu, Xu, Wog, Wog, Xu, Xu, Xu, Xu, Xu, Xu, Xu, Xu, Xu, Xu, Xu, Xu, Xu, Xu, Xu, Xu, Xu, Xu, Xu, Xu, Xu, Xu, Xu, Xu, Xu, Xu, Xu, Xu, Xu, Xu, Xu, Xu, Xu, Xu, Xu, Xu
