border_size=1
usage=map

Qxu, Mm, Mm, Mm^Xm, Mm^Xm, Xu, Xu, Xu, Xu, Xu, Mm^Xm, Mm^Xm, Mm, Hh, Ss, Ss, Wog, Wwg, Md, Md, Md, Md^Xm, Md^Xm, Md^Xm, Md^Xm, Md^Xm, Md, Md^Xm, Md^Xm, Md^Xm, Md^Xm, Md^Xm, Md, Md, Md, Md, Md, Md, Md^Xm, Md^Xm, Md^Xm, Hhd, Hhd^Fmw, Gd, Re, Re, Md, Md, Md^Xm, Md, Md^Xm, Md^Xm
Mm, Qxu, Qxu, Mm, Mm^Xm, Mm^Xm, Xu, Xu, Xu, Xu, Mm^Xm, Hh, Hh, Ss, Wwf, Ss, Wog, Wwg, Md, Hhd, Md, Md, Md, Md, Hhd, Md, Md, Md, Md, Md^Xm, Md^Xm, Md, Hhd^Dr, Md, Gd^Fdw, Md^Xm, Md^Xm, Md, Rd, Hhd, Hhd, Hhd, Gd, Re, Hhd, Md, Md, Md, Md, Md^Xm, Md^Xm, Md^Xm
Mm^Xm, Mm, Qxu, Mm, Mm, Mm^Xm, Xu, Xu, Xu, Xu, Xu, Mm^Xm, Mm, Ss, Wwf, Wog, Wwg, Wwg, Gd, Hhd, Hhd, Md, Md, Hhd, Md, Md, Hhd, Md, Md, Md, Md, Md, Hhd, Hhd^Fmw, Gd^Fdw, Gd^Fdw, Rd, Rd, Gd^Fdw, Hhd^Fmw, Gll^Fmw, Gd^Fmw, Gd, Re, Hhd^Vhh, Hhd^Fmw, Hhd, Md, Md, Md, Md, Md
Mm^Xm, Mm^Xm, Qxu, Mm, Mm, Mm^Xm, Xu, Xu, Xu, Xu, Xu, Mm^Xm, Mm, Wwf, Wog, Wog, Wwg, Re, Gll^Fmf, Gd, Gd, Gd^Fetd, Gd, Hhd, Gd, Md, Gd, Hhd, Hhd, Md, Md, Md, Rb, Gll^Fdw, Gll^Fmw, Gd^Fetd, Re, Gd^Fdw, Gd^Fdw, Re^Fdw, Rb, Rb^Es, Re, Re, Rd, Gll^Fmw, Gll^Fmw, Hhd^Dr, Md, Md^Xm, Md, Md
Xu, Mm^Xm, Mm^Xm, Qxu, Qxu, Xu, Xu, Xu, Uhe, Xu, Xu, Mm^Xm, Mm, Wwg, Wwg, Wog, Wwg, Re, Re, Gll^Fmw, Gll^Fmf, Re, Re, Gd^Vhr, Re, Gd, Gd, Gd, Gd, Rd, Re, Hhd, Re, Rd, Rb, Re, Re^Es, Gd, Gll^Fmw, Re^Fmw, Rd, Re, Gll^Fmw, Gd^Fmw, Re, Rd, Hhd, Md, Md, Md, Md, Md
Xu, Xu, Xu, Xu, Xu, Qxu, Qxu, Uhe^Dr, Uhe^Ii, Uhe, Xu, Xu, Mm^Xm, Mm, Wwg, Wog, Wog, Wwg, Re, Gll^Fmw, Gll^Fmw, Gd, Gs, Re, Gs, Gll^Fp, Gll^Fdw, Gll^Fp, Gd^Fp, Gd, Re, Re, Gd, Re, Gd, Re, Rb, Re, Re, Rd, Gll, Gd^Fetd, Gll^Fdw, Gd^Fmw, Gd^Fdw, Hhd, Hhd, Md, Md^Xm, Md, Md, Md
Xu, Xu, Xu, Xu, Xu, Qxu, Cud, Uhe, Uue, Uue, Re^Vu, Xu, Xu, Mm, Wwg, Wog, Wog, Wwg, Wwg, Gd^Fmw, Gg, Gd, Gd, Gg^Fet, Gs, Gll^Fp, Gll^Fdw, Gll^Fmw, Gd^Fmw, Re, Gd, Gd, Hhd^Vhhr, Re, Hhd, Hhd, Hhd, Hhd, Hhd, Hhd, Hhd, Re, Re, Gll^Fdw, Gll^Fmw, Hhd^Fdw, Re, Hhd, Hhd, Md^Xm, Md^Xm, Md
Xu, Xu, Xu, Xu, Xu, Xu, 5 Cud^Kov, Uhe, Uue^Ii, Re, Uue, Xu, Xu, Mm, Mm, Wog, Wog, Wog, Wog, Wwg, Wwg, Gg, Ch, Re, Re, Gd, Gd, Gll^Fmw, Gd, Gs, Gg, Gd, Hhd, Hhd, Md, Md, Md, Md, Cud, Cud, Hhd, Gd, Re, Gll^Fmw, Gll^Fmw, Rb, Re^Es, Re, Hhd, Mm, Hhd, Md
Xu, Xu, Uhe^Uf, Uhe^Uf, Uh^Uf, Cud, Uh^Uf, Uh^Uf, Uue, Uue^Ii, Uue^Ii, Xu, Md^Xm, Md^Xm, Wwf, Wwf, Wog, Wog, Wog, Wog, Wog, Wwg, Wwg, Wwg, Wwg, Gd^Es, Gs, Re, Chr, Gg, Re, Gs, Gd, Md, Md, Md, Md^Xm, Md, Cud^Dr, 4 Kud, Cud, Hhd, Hhd, Gd, Rb, Re, Gd, Rb, Gll^Fdw, Mm, Hhd, Hhd
Xu, Xu, Uhe, Uue, Uue, Uue, Uue^Ii, Uue^Ii, Uu^Uf, Uue, Rd, Xu, Md, Md^Xm, Mm, Wwf, Wwg, Wog, Wwg, Wog, Wog, Wog, Wog, Wog, Wog, Gs, Wwg, Re, Wwg, Ds, Ds, Re, Dd, Hhd, Hhd, Md, Md^Xm, Md, Cud^Dr, Cud, Md, Cud, Hhd, Hhd, Rd, Rd, Gll^Fmw, Gll^Fdw, Gll^Fdw, Rb, Md, Md
Xu, Xu, Uue, Xu, Xu, Uu, Ur^Ii, Ur, Uue, Rd^Ii, Re, Md, Ce, Mm, Ce, Hh, Hh, Wwg, Wwg, Wwg, Wwg, Wog, Wwg, Wog, Wog, Wog^Bw|r, Wog, Wwg^Bw|, Wwg, Wwg, Wwg, Dd, Dd, Dd, Hhd, Hhd, Md, Md^Xm, Hhd, Md, Md^Xm, Md^Xm, Md, Md, Wwg, Rd, Wwg, Gll^Fdw, Wwg, Gd, Wwg, Md
Xu, Uue, Uue, Uue, Xu, Ur, Uue, Uue^Ii, Re, Re, Ce, Ce, Gs, Ce, Rd, Gs, Gs, Rd, Rp^Vhcr, Gg, Ce, Wwg, Hhd^Fmf, Wwg, Wwg, Wog^Bw|r, Wog, Wog^Bw|, Wog, Wog, Wog, Wwg, Wwg, Dd, Wwg, Re, Hhd, Md, Hhd, Md, Wwg, Md^Xm, Wwg, Md, Wog, Wwg^Bw|, Wog, Wwg^Bw|, Wog, Wwg, Wog, Wwg
Xu, Xu, Xu, Xu, Xu, Xu, Hhd, Uue, Rd, Ce, Ce, Gd, Gd^Es, Gd, Rd, Gs, Ce, Rp, Gs, Gll^Fp, Gll^Fp, Ce, Gll^Fp, Gll^Es, Gg, Wwf^Bw|, Wwf, Wwf^Bw|r, Wwg, Wog, Wog, Wog, Wog, Wwg, Wog, Wwg, Wog, Hhd^Es, Wog, Wog, Wog, Wog, Wog, Wog, Wwg, Wog^Bw|, Wog, Wog^Bw|, Wog, Wog, Wog, Wog
Md, Xu, Md^Xm, Md^Xm, Md^Xm, Md^Xm, Md, Hhd, Hhd, Rd, Gs, Gd, Re, Gll^Fmf, Re, Ce, 2 Ket, Ce, Gs, Gll^Ecf, Gll^Fp, Ce, Gll^Fp, Gll, Rp, Rp, Rp, Rp, Rp, Wwg, Wwg, Wwg, Wwg, Wog, Wog, Wog, Wog, Wog, Wog, Wog, Wog, Wog, Wwg, Wwg, Re, Wwg^Bw|, Wwg, Wwg^Bw|, Wwg, Wog, Wwg, Wog
Md, Md, Md, Md, Md, Md, Hhd^Vhhr, Hhd, Rd, Rd, Gd, Gs^Vh, Gg, Re, Gs, Ce, Ce, Ce, Rr, Gll, Gs, Ce, Ce, Rp, Rp, Rp, Gs, Gg, Gg, Rr, Rp, Gs, Gs^Eff, Wwg, Wwg, Wwg, Wwg, Wog, Ww^Ewl, Wog, Wwg, Wwg, Gll, Re, Gd^Fmf, Gd^Fp, Gll^Fp, Re, Re, Wwg, Wwf, Wwg
Md, Md, Hhd, Hhd, Md, Md, Hhd, Hhd, Re, Gs, Gs, Gs, Ce, Gs, Gs^Ecf, Gg, Gg, Gs, Gg, Rr, Rr, Ce, Rr, Rp, Gg, Gs, Gll^Fmw, Gs, Gll^Fp, Gg, Rp, Re, Gg, Gg^Eff, Gg^Eff, Gg, Wwg, Wog, Wwg, Wwg, Hh^Dr, Gll, Gll^Fp, Gll^Fmw, Gll^Fmw, Gll^Fmf, Gll^Fp, Re, Gll, Re, Re, Re
Md^Xm, Md, Md, Hhd, Rd, Gd, Re, Re, Gd, Gd, Gd, Rd, Ce, Gs, Gll, Gll, Gll^Fp, Gll^Fp, Ce, Gg, Rp, Rr, Rp, Rp, Gs, Gll^Fp, Gll^Fp, Gll^Fmw, Gll^Fmf, Gll^Fmw, Gll^Fmw, Rp, Rr, Gg, Gg, Gg, Wwg, Wwg, Wwg, Hh, Hh, Gll, Hhd, Gll^Fmw, Gd^Vhr, Gll, Re, Chr, Chr, Gll, Gll^Fmw, Gll^Fmw
Md^Xm, Md, Md, Md, Hhd, Gd, Dd, Re, Hd, Gd, Hhd, Hh, Hh, Ce, Ce, Ce, Ce, Ce, Gs, Gg, Rp, Rp, Gg, Gg, Gll^Fp, Gs^Fp, Hh, Gll^Fp, Hh^Fp, Gll^Fp, Gll^Fp, Gg, Gg, Re, Re, Hh, Ch, Wwg, Wwg, Chr, Hh, Hh^Fms, Gd^Fms, Hhd, Gll, Re, Chr, 3 Khr, Chr, Gll, Gll^Fmf, Gll^Fmw
Md^Xm, Md^Xm, Md, Md, Hhd, Hd, Rd, Re, Hd, Hd, Mm, Hhd, Mm, Hh, Hh, Gs, Gg, Gll^Fp, Gll^Fp, Rp, Rp, Rp, Rr^Vd, Gg, Gs, Gll^Fp, Hh, Hh^Fp, Mm, Hh^Fp, Hh^Fp, Gll, Gg, Re, Hh^Fp, Re, Gg, Gg, Wwg, Wwg, Gs, Gd, Gll, Hh, Gd, Rd, Hhd^Fmw, Hhd, Hh, Gll^Fmf, Gll^Fp, Gll^Fmf
Md, Md, Hhd, Hhd, Hd, Hd, Dd, Rd, Hd, Hhd, Mm, Mm, Md^Xm, Mm, Cud, Gg, Gll^Fp, Gll^Fp, Gll^Fp, Gg, Rr, Rp, Gg^Fet, Gll^Fp, Gg, Gs, Cud, Mm, Mm^Xm, Mm, Mm, Hh^Fp, Gg, Gg, Re, Re, Gs^Efm, Gg, Gg, Wwg, Gs, Gd^Es, Gll, Gd, Gd^Fdf, Gd^Fmw, Gll^Fmw, Hhd, Hh^Fp, Gll^Fp, Gll, Gll^Fp
Md, Hhd, Hhd, Hhd, Hd, Hd, Hd, Dd, Hd, Hhd, Hhd, Md^Xm, Xu, Xos, Cud, Gg, Gs, Gll^Fp, Gg, Gg, Rr, Gg, Gll^Fp, Gll^Fp, Gg, Gg, Cud, Xos, Xu, Mm, Mm, Hh^Fp, Gg, Gg, Gg, Re, Re, Gs^Efm, Gll^Fp, Wwg, Wwg, Gs, Re, Gll^Fp, Re, Gd^Fdf, Re, Gll^Fmf, Gll^Fdf, Hh, Gg, Gll
Md, Hhd, Hhd, Hhd, Hhd, Hd, Hd, Dd, Dd, Hd, Hhd, Md^Xm, Xu, Xos, Cud, Gs, Gs, Gg, Rr^Vd, Rp, Rp, Gg, Gll^Fp, Gll^Fp, Gg, Gg, Cud, Xos, Xu, Mm^Xm, Hh, Hh, Hh, Gg, Gs^Fp, Rp, Rp, Gs, Gs, Gll^Fp, Wwf^Bw/, Re, Gs, Re, Gll^Fp, Re, Gll^Fmf, Re, Re, Gll, Gs, Gll
Md, Md, Md, Md^Xm, Md^Xm, Hhd, Md, Md, Hhd, Hd, Hhd, Md, Xu, Xos, Cud, Gg, Gg, Gg^Fet, Gg, Rr, Rp, Rp, Gs, Gs, Gg, Gg, Cud, Xos, Xu, Mm^Xm, Mm, Mm, Mm, Hh, Gg, Gs, Rp, Re, Re, Re, Wwg, Gs, Gs^Efm, Gll^Fp, Gll^Fp, Gll^Fp, Gll^Fp, Gll^Fp, Gs, Re, Re, Re
Md, Md, Md, Md, Md, Md^Xm, Md^Xm, Md, Hhd, Hhd, Md, Md, Xu, Xos, Xos, Cud, Cud, Gs, Gs, Rp, 1 Kud, Gg, Gg, Gs, Cud, Cud, Xos, Xos, Xu, Mm^Xm, Mm^Xm, Mm^Xm, Mm, Hh, Gs, Rr^Vd, Gg, Gg, Gg^Efm, Gs^Es, Wwg, Gg, Gg, Gs, Gg, Gll^Fp, Gg, Gs^Fms, Gd, Gd, Gg, Gll^Es
Md, Md^Xm, Md, Md, Mv, Md, Md, Hhd, Hhd, Hd, Md, Md, Xu, Xu, Xu, Xos, Xos, Cud, Cud, Cud, Rr, Cud, Cud, Cud, Xos, Xos, Xu, Xu, Xu, Mm^Xm, Mm^Xm, Mm, Mm, Hh, Gll^Fmf, Gs, Gg, Gg^Efm, Gg^Efm, Gg, Wwg, Wwg, Wwg, Gg, Gs, Gg^Es, Gg, Gg^Efm, Gg^Efm, Gg, Gg, Gg
Hhd, Md, Md, Md, Md, Md, Md, Md^Xm, Md^Xm, Hhd, Md^Xm, Xu, Xu, Xu, Xu, Xu, Xos, Xos, Cud, Urb, Rr, Urb, Cud, Xos, Xos, Xu, Xu, Xu, Xu, Xu, Mm^Xm, Hhd, Hhd, Mm, Hhd^Fp, Gll^Fp, Gll^Fp, Gg, Gg, Gs, Gs, Gg, Gg, Wwg, Wwg, Gs, Gg, Gs^Efm, Gs, Gs^Efm, Gs, Gg
Hhd, Hhd, Hhd, Md, Hhd, Hhd, Hhd, Md^Xm, Md, Md, Md^Xm, Md^Xm, Xu, Xu, Xu, Xu, Xos, Xos, Cud, Urb, Rr, Urb, Cud, Xos, Xos, Xu, Xu, Xu, Xu, Xu, Mm^Xm, Mm, Mm^Xm, Mm, Hhd^Fp, Gll^Fp, Gll^Fp, Gll^Fp, Gll^Fp, Gs, Gll^Fp, Gg, Gs, Gg, Wwg, Gg, Gg, Gs, Gll^Fp, Gg, Gs, Gg
Md, Hhd, Md, Md^Xm, Md^Xm, Md^Xm, Md, Md^Xm, Md, Md, Md^Xm, Xu, Xu, Xu, Xu, Xu, Xos, Xos, Cud, Urb, Rr, Urb, Cud, Xos, Xos, Xu, Xu, Xu, Xu, Xu, Xu, Mm^Xm, Mm, Mm^Xm, Hhd, Hhd, Hh, Hh^Fp, Gll^Fp, Gll^Fp, Gll^Fp, Gll^Fp, Gs, Gs, Wwg, Wwg, Gg, Gll^Fp, Gll^Fp, Gg, Gg, Gg
Md, Md, Md, Md^Xm, Md^Xm, Md^Xm, Md, Md^Xm, Md, Md, Xu, Xu, Xu, Xu, Xu, Xu, Xos, Xos, Cud, Urb, Rr, Urb, Cud, Xos, Xos, Xu, Xu, Xu, Xu, Xu, Xu, Mm^Xm, Mm, Mm, Mm, Mm, Hh, Hh, Hh, Gll^Fp, Hh, Gg, Gg, Gs, Wwg, Wog, Wwg, Gg, Gs, Gll^Fp, Gll^Fp, Gg
Md, Md, Md, Md, Md, Hhd, Hhd, Md, Md, Md, Xu, Xu, Xu, Xu, Xu, Xu, Xos, Xos, Cud, Urb, Rr, Urb, Cud, Xos, Xos, Xu, Xu, Xu, Xu, Xu, Xu, Mm^Xm, Mm^Xm, Mm, Mm, Mm, Mm, Hh, Gg, Hh, Gg, Hh^Dr, Gg, Gg, Gg, Wog, Wog, Wwg, Gg, Gg, Gg, Gg
