border_size=1
usage=map

Xu, Xu, Xu, Xu, Xu, Xu, Xu, Xu, Xu, Md, Mm, Md, Mm, Md, Mm^Xm, Md, Mm, Md, Mm, Md, Mm, Md, Mm, Md, Mm, Md, Mm^Xm, Md, Mm, Md, Mm, Md, Mm^Xm, Md, Mm, Wog, Wog, Wog, Wog, Wog, Mm, Md, Mm, Md, Mm^Xm, Md, Mm^Xm, Md, Mm^Xm, Md, Xu, Xu, Xu, Xu, Qxu, Xu, Xu, Xu, Xu, Xu, Xu, Ur, Ur^Ii, Ur, Ur^Ii, Ur
Xu, Xu, Xu, Xu, Xu, Xu, Xu, Xu, Xu, Mm^Xm, Mm, Mm^Xm, Mm^Xm, Mm^Xm, Mm, Mm^Xm, Mm, Mm, Mm^Xm, Mm^Xm, Mm, Mm, Mm, Mm^Xm, Mm^Xm, Mm^Xm, Mm^Xm, Mm, Mm^Xm, Mm, Mm, Mm^Xm, Mm^Xm, Mm^Xm, Wog, Ss, Wog, Ss, Sm, Wog, Mm, Mm^Xm, Mm^Xm, Mm^Xm, Mm, Mm^Xm, Mm^Xm, Mm^Xm, Mm^Xm, Mm^Xm, Xu, Xu, Xu, Qxu, Qxu, Xu, Qxu, Xu, Xu, Xu, Uu, Uu, Ur, Ur^Ii, Uu, Ur^Ii
Xu, Xu, Uhe^Uf, Uhe^Uf, Uh^Uf, Xu, Uh^Uf, Uh^Uf, Xu, Xu, Mm, Mm, Mm^Xm, Mm^Xm, Mm, Mm, Hhd, Mm, Mm, Mm, Hhd, Mm, Mm^Xm, Mm^Xm, Mm, Mm, Mm^Xm, Mm, Mm, Mm, Mm^Xm, Mm, Mm, Mm, Ds, Sm, Wog, Wog, Ss, Sm, Hh, Mm, Mm, Mm^Xm, Mm, Mm^Xm, Mm^Xm, Mm^Xm, Mm^Xm, Mm^Xm, Xu, Xu, Xu, Xu, Xu, Qxu, Qxu, Qxu, Xu, Xu, Uu, Uu, Urb, Uu, Xu, Xu
Xu, Xu, Uhe, Uue, Uu^Vct, Uue, Uue, Xu, Uu^Uf, Xu, Hh, Mm, Mm, Mm, Mm, Mm, Hh, Hh, Hh^Vhr, Hhd, Mm, Mm, Mm^Xm, Mm, Mm^Xm, Mm^Xm, Mm^Xm, Mm, Hh, Mm, Hh, Hh, Ss, Ss, Ss, Wog, Ss, Ss, Wog, Ds, Ds, Mm, Mm, Mm, Mm^Xm, Mm, Mm, Mm^Xm, Mm^Xm, Xu, Xu, Xu, Xu, Xu, Uh, Qxu, Qxu, Qxu, Uu, Cud, Urb, Urb, Xu, Xu, Xu, Xu
Xu, Xu, Uh^Uf, Uu, Uu, Uu, Ur, Ur, Uu, Uu^Dr, Hhd, Hhd, Mm, Mm, Gd, Hh, Hh, Hhd^Es, Hh, Mm, Hhd, Mm, Mm, Mm, Mm, Mm, Mm^Xm, Mm^Xm, Hh, Ss, Ss, Wog, Wog, Ss, Wog, Wog, Ss, Ss, Wog, Ss, Wog, Hh, Mm, Mm^Xm, Mm, Mm, Mm, Mm^Xm, Mm^Xm, Xu, Xu, Xu, Xu, Uh, Uh, Uu, Uu, Uu, Urb, Urb, Uu, Cud, Xu, Xu, Xu, Xu
Xu, Xu, Xu, Uh, Uu, Ur, Uue, Uu, Uu, Rb, Gd, Gd, Gd, Gd, Gd, Hhd, Gd, Hhd, Hh, Hhd, Hh^Fp, Hhd, Hh^Fds, Mm, Gd, Mm, Mm, Mm^Xm, Mm^Xm, Hh, Mm^Xm, Ss, Wog, Wog, Ss, Ss, Mm, Ss, Ss, Wog, Ss, Hh, Mm, Mm, Mm, Mm, Mm, Mm, Mm, Mm^Xm, Mm^Xm, Xu, Xu, Xu, Xu, Uu, Urb, Urb, Urb, Urb, Uu, Uh, Xu, Xu, Xu, Qxu
Xu, Xu, Uu, Xu, Cud, Cud, Cud, Uu, Xu, Hhd, Hhd, Gd, Gd, Gd, Gg^Fms, Gd, Gll^Fmf, Gll^Fp, Gll^Fp, Gd, Gs^Fms, Hh^Fds, Gs^Fms, Hh^Fms, Gd, Gd, Mm, Mm, Mm, Mm^Xm, Wog, Wog^Xo, Mm^Xm, Ss, Mm, Ss, Mm, Mm, Mm, Ss, Wog, Hh, Mm, Mm, Mm, Mm, Mm, Mm, Mm, Mm^Xm, Mm^Xm, Mm^Xm, Mm^Xm, Xu, Xu, Uu, Urb, Urb, Urb, Urb, Uu, Uh, Xu, Xu, Qxu, Xu
Xu, Xu, Cud, Cud, Cud, 2 Kud, Xu, Xu, Mm^Xo, Hh, Hh, Gd, Gd, Gg^Fms, Gg^Fms, Gll^Fp, Gll^Fmf, Gll^Fp, Gll^Fp, Gll^Fp, Gs^Fms, Gd^Fmf, Gd^Fmf, Gd, Gs^Fms, Gd, Gd, Gs, Gs, Ss, Wog, Mm, Mm, Mm^Xm, Mm^Xm, Mm^Xm, Mm^Xm, Mm^Xm, Mm, Wog, Hh, Sm, Hhd, Hhd, Hhd, Mm, Hhd^Vhr, Mm, Mm, Mm, Mm, Mm^Xm, Xu, Xu, Uu^Vud, Urb, Uu, Uu, Uu, Uu^Vct, Xu, Xu, Qxu, Xu, Qxu, Qxu
Xu, Uu, Xu, Uue, Uue, Cud, Xu, Mm^Xo, Mm, Mm^Xo, Mm^Xo, Gd, Gd, Gg^Fdf, Gll^Fmf, Gg^Fms, Gll^Fp, Gll^Fmf, Rd, Gll^Fp, Gs^Fms, Gg^Fms, Rd^Fms, Gs^Fms, Gs^Fms, Gg^Fdf, Gll^Fmf, Gll^Fp, Gll^Fp, Gll^Fp, Ds^Em, Wog, Ss, Mm, Mm^Xm, Mm^Xm, Mm, Mm, Wwrg, Wog, Sm, Hh, Gll, Gd, Hh, Hhd, Hhd, Hhd, Hh^Fp, Mm, Mm^Xm, Mm^Xm, Xu, Xu, Uu, Uu, Ur, Ur, Uu, Xu, Xu, Xu, Qxu, Qxu, Xu, Qxu
Xu, Xu, Uu^Vct, Uue, Ur, Uue, Xu, Mm, Mm, Mm, Hhd, Mm^Xo, Gd^Xo, Gg^Fdf, Gg^Fdf, Gg^Fmf, Rd^Fp, Rd, Gd, Rd, Rd, Rd^Fp, Gs^Fds, Rd^Fds, Rd^Fp, Gll^Fmf, Gll^Fmf, Gll^Fp, Gll^Fp, Gll^Fp, Gll^Fp, Wog, Ss, Ss, Ss, Ss, Wwrg, Wwrg, Sm, Sm, Gs, Gg, Gll^Efm, Gll, Gs, Gs, Gs^Fms, Gll^Fms, Gs^Fms, Hh^Fp, Mm, Mm^Xm, Mm^Xm, Xu, Uu, Uu, Ur, Uu, Uu, Cud, Cud, Cud, Qxu, Qxu, Qxu, Qxu
Xu, Xu, Uu, Uue, Uu, Uue, Xu, Gd, Gd, Hh, Mm, Mm, Gs^Efm, Gs^Xo, Gs^Xo, Rd^Fms, Gd, Gd, Gd, Gd, Gd, Gll^Fmf, Gs^Fms, Gs^Fms, Gd, Rd^Fms, Rd, Gll^Fmf, Gll^Fp, Gll^Fp, Wog, Wog, Ds, Ds, Gs, Sm, Gs^Es, Hh, Gll^Fp, Gll^Fp, Gll^Fp, Gg, Gg, Gs, Gll^Fp, Gd^Fdf, Gd^Fdf, Gs^Fms, Gll^Fmf, Hh^Fp, Hh, Mm, Hh, Xu, Cud, Uu, Ur^Es, Uu, Uu, Cud, Cud, Cud, Xu, Qxu, Qxu, Xu
Xu, Uh^Uf, Uh^Uf, Ur, Uu^Vu, Xu, Mm, Gd, Gd, Hh, Gd, Gd, Rd, Rd, Rd^Xo, Rd, Gs, Gd, Gd, Gd, Mm, Gd, Mm, Gd, Gd, Gd, Wog, Rd, Wog^Bw\, Wog, Rd, Rd, Rd, Gs, Re, Re, Gs, Gll^Fp, Gs^Fms, Gll^Fp, Gll^Fp, Gll^Fp, Re, Re, Re, Re, Re, Re, Re, Gll^Fdf, Gll, Hh, Gll, Xu, Uu, Uu, Uu, Ur, Uu, Urb, Urb, 3 Kud, Cud, Qxu, Xu, Xu
Xu, Xu, Qxu, Ur, Xu, Xu, Mm^Xm, Mm, Mm, Gd, Gd, Rd, Gs^Es, Gs^Es, Gs^Efm, Hhd^Xo, Hh^Xo, Mm, Mm, Mm, Mm, Mm, Mm, Gd, Ds, Ds, Wog, Wog, Ds^Cov, Wog^Bw\, Ds^Cov, Gs, Gs, Re, Gs^Es, Gs, Gs, Gll^Fp, Gs^Fms, Gs^Fms, Re, Re, Gs, Gs, Gll^Fp, Gs^Fms, Gll^Fmf, Gll^Fmf, Gll^Fp, Re, Re, Gs, Re, Re, Uu, Ur, Ur, Ur, Uu, Urb, Urb, Cud, Cud, Cud, Xu, Xu
Qxu, Qxu, Qxu, Xuc, Xu, Mm^Xm, Mm^Xm, Mm, Hh, Gd, Gs^Es, Rd, Gs, Gs^Efm, Hhd, Hh, Mm^Xo, Mm^Xm, Mm^Xm, Mm, Mm, Mm, Gd, Ds, Ds, Gs, Wog, Wog, Ds^Cov, 4 Ket, Ds^Cov, Ds, Gs, Re, Re, Re, Re, Re, Re^Fms, Re, Gs^Es, Gs, Gg, Gs^Efm, Gs, Gll^Fp, Gll^Fp, Gll^Fp, Gs^Fms, Gs, Gd, Re, Gll^Es, Gll, Cud, Uu, Uu, Ur, Ur, Uu, Uu, Cud, Cud, Cud, Xu, Xu
Xu, Xu, Xu, Xu, Mm^Xm, Mm, Mm, Hh, Hh, Hh, Gs, Rd, Gs, Hh, Mm, Hhd, Mm, Mm^Xo, Mm^Xm, Mm, Hhd, Ds, Ds, Ds, Ds, Wog, Wog, Wog, Gs, Gs^Cov, Rb, Gd, Gd, Gg, Gs^Fms, Gll^Fmf, Hhd^Fmf, Hhd^Fmf, Gd^Fdf, Gll^Fp, Gs^Fds, Gs^Fms, Gll^Fmf, Gg, Hhd^Fmf, Gll^Fmf, Hhd^Fmf, Hh^Fp, Hh, Gd, Hhd, Gd, Mm, Xu, Xu, Uu, Uu^Vud, Uu, Ur, Uu, Uu, Uu, Urb, Urb, Urb, Xu
Xu, Xu, Mm^Xm, Mm, Mm^Xm, Mm, Hhd, Hhd, Mm, Hhd, Hhd^Es, Rd, Gs, Hh, Mm, Hh, Mm^Xm, Mm^Xo, Mm^Xm, Mm, Hhd^Fp, Gs^Fp, Sm, Ds, Ss, Wog, Ss, Gs, Gs^Fms, Gd, Hhd, Hhd, Hh, Gd, Gs^Fms, Gll^Fmf, Gll^Fmf, Gd^Fdf, Gll^Fp, Gs^Fds, Gs^Fms, Gll^Fmf, Hh, Hhd^Fmf, Hhd^Fmf, Mm, Mm, Mm, Mm, Hh, Hh, Hhd, Mm, Mm^Xm, Mm^Xm, Xu, Xu, Uu, Uu, Uu, Uu^Es, Uu, Uu^Vct, Urb, Urb, Xu
Mm^Xm, Mm, Mm^Xm, Mm^Xm, Mm, Mm, Mm, Mm, Hh, Hhd, Gs, Rd, Gs, Hh, Hh, Mm, Mm^Xm, Mm^Xm, Mm, Mm, Hh, Hhd^Fp, Sm^Em, Wwf, Ss, Wog, Wog, Rb, Hhd^Fmf, Hhd^Fp, Hh^Fp, Hh, Hhd^Fp, Hh, Hh, Hh^Fp, Hhd^Fmf, Gll^Fmf, Hhd, Gll^Fp, Hh, Hh, Mm, Hh, Mm, Mm, Mm, Mm, Mm, Mm, Mm, Mm, Mm^Xm, Mm^Xm, Xu, Xu, Xu, Cud, Cud, Uu, Uu, Uu, Ur, Ur, Xu, Xu
Mm^Xm, Mm, Mm, Mm^Xm, Mm, Mm, Mm, Gd, Gs, Gs, Gg^Fp, Rd, Gs, Gs^Efm, Gs^Efm, Mm^Xm, Mm, Mm^Xm, Mm^Xm, Hh, Mm, Sm^Uf, Rb^Em, Wwf, Rb, Ds, Wog, Wog, Hh, Gll^Fp, Hh^Fp, Hh^Fp, Hh^Fds, Hh^Fp, Hhd^Fp, Hhd^Fp, Hhd, Hhd^Vhhr, Hh, Mm, Mm, Mm, Mm, Mm, Mm, Mm, Mm, Mm, Mm^Xm, Mm^Xm, Mm^Xm, Mm^Xm, Xu, Xu, Xu, Xu, Ur, Ur, Ur, Xu, Xu, Uu, Xu, Xu, Xu, Xu
Mm, Mm^Xm, Mm, Mm, Mm, Hh, Hh, Mm, Gs, Gg^Fp, Rd^Fms, Rd^Fp, Gg^Fp, Gs, Gs^Fms, Hh^Fms, Hh^Fms, Mm, Mm^Xm, Mm, Mm^Xm, Mm, Ds, Ds, Wo, Wog, Hhd^Fdw, Hhd, Mm, Hhd, Hh, Hhd, Hhd, Hhd, Mm, Hh, Mm, Hh, Mm, Mm, Mm, Mm, Mm, Mm^Xm, Mm^Xm, Mm, Mm, Mm^Xm, Xu, Mm^Xm, Xu, Xu, Xu, Xu, Xu, Xu, Uu, Ur, Ur, Uu, Qxu, Xu, Xu, Xu, Xu, Xu
Mm^Xm, Mm, Hh, Hh, Gd, Gd, Gs^Efm, Gs^Fms, Gs^Fds, Rd^Fds, Gll^Fmf, Gll^Fmf, Gg^Fms, Gs, Hh, Hh^Fp, Hhd^Fmf, Mm, Mm, Mm^Xm, Mm, Mm, Mm^Xm, Mm, Wo, Wo, Hhd, Hhd, Mm, Mm, Mm, Mm, Mm, Mm, Mm, Mm, Mm, Mm, Mm, Mm, Mm^Xm, Mm, Mm, Mm^Xm, Xu, Xu, Xu, Xu, Xu, Xu, Xu, Xu, Qxu, Qxu, Qxu, Xu, Xu, Ur, Ur, Uu, Uu, Qxu, Qxu, Xu, Xu, Xu
Mm, Mm^Xm, Hhd^Fdf, Gs^Fms, Gs^Es, Gs^Es, Gs^Es, Gll^Fmf, Rd, Rd^Fds, Gg^Fms, Gs^Fms, Gs^Es, Gs, Gs^Es, Hh^Fp, Mm, Mm^Xm, Mm^Xm, Mm^Xm, Mm^Xm, Mm, Mm, Mm, Wo, Mm, Mm, Mm, Mm, Mm, Mm, Mm, Mm, Mm, Mm, Mm, Mm, Mm, Mm, Mm, Mm, Mm^Xm, Mm, Mm^Xm, Xu, Xu, Xu, Xu, Qxu, Qxu, Qxu, Qxu, Qxu, Qxu, Ur, Xu, Ur, Ur, Uu, Uu, Uu, Qxu, Qxu, Xu, Xu, Xu
Mm, Mm, Hhd^Fdf, Hhd^Fmf, Rd, Rd, Rd, Rd, Gs^Efm, Gll^Fp, Gs^Fms, Gs^Fds, Gll^Fmf, Gs^Es, Gs^Efm, Mm, Hh, Mm^Xm, Mm, Mm, Mm^Xm, Mm^Xm, Mm, Mm^Xm, Wo, Wo, Mm^Xm, Mm, Mm^Xm, Mm, Mm^Xm, Mm, Mm, Mm, Mm^Xm, Mm, Mm, Mm^Xm, Mm^Xm, Mm, Mm, Mm, Xu, Xu, Xu, Xu, Xu, Qxu, Qxu, Qxu, Xu, Xu, Uu, Ur, Ur, Ur, Uu, Uu, Uu, Uu, Qxu, Qxu, Qxu, Xu, Xu, Xu
Hh, Hh, Gll^Fp, Gll^Fp, 1 Rd, Rd, Gd, Gs, Gs^Efm, Hh^Fds, Hhd^Fdf, Hhd^Fmf, Hh, Hh, Gs, Gd, Hh, Hh, Hh, Mm^Xm, Mm, Mm^Xm, Mm^Xm, Mm, Wo, Wo, Mm^Xm, Mm^Xm, Mm^Xm, Mm^Xm, Mm, Mm, Mm^Xm, Mm, Mm^Xm, Mm^Xm, Mm^Xm, Mm^Xm, Mm^Xm, Mm^Xm, Mm^Xm, Mm^Xm, Xu, Xu, Xu, Xu, Qxu, Qxu, Xu, Xu, Xu, Xu, Uu, Ur, Ur, Uu, Xu, Xu, Xu, Qxu, Qxu, Qxu, Xu, Xu, Xu, Xu
Gs, Gs, Gs, Gs, Rd, Gs, Gd, Hh, Hhd^Fmf, Hh^Fms, Hh^Fds, Hhd^Fdf, Mm, Mm, Gd, Gd, Gd, Mm, Mm, Mm, Mm, Mm, Mm^Xm, Mm^Xm, Mm^Xm, Wo, Wo, Mm^Xm, Mm^Xm, Mm^Xm, Mm, Mm^Xm, Mm^Xm, Mm, Mm, Mm, Mm, Mm, Xu, Xu, Xu, Xu, Xu, Xu, Xu, Qxu, Qxu, Qxu, Xu, Xu, Xu, Xu, Xu, Ur, Ur, Uu, Uu, Xu, Xu, Xu, Qxu, Qxu, Xu, Xu, Xu, Xu
Gs, Gs, Rd, Rd, Gs, Gs, Hh, Hh, Mm, Mm, Mm, Mm, Mm, Mm, Mm, Gd, Mm^Xm, Mm, Mm^Xm, Mm^Xm, Mm, Mm^Xm, Mm^Xm, Mm, Mm^Xm, Wo, Wo, Mm^Xm, Mm^Xm, Mm, Mm^Xm, Mm^Xm, Mm^Xm, Mm^Xm, Mm^Xm, Mm, Xu, Xu, Xu, Xu, Xu, Xu, Xu, Xu, Qxu, Qxu, Qxu, Qxu, Xu, Xu, Uu, Xu, Uu, Ur, Ur, Uu, Uu, Xu, Xu, Xu, Xu, Qxu, Qxu, Xu, Xu, Xu
