border_size=1
usage=map

Qxu, Mm, Mm, Mm^Xm, Mm^Xm, Xu, Xu, Xu, Xu, Xu, Xu, Xu, Xu, Md, Mm^Xm, Md, Mm, Md, Mm, Md, Mm, Md, Mm, Md, Mm, Md, Mm^Xm, Xu, Xu, Xu, Xu, Xu, Xu, Xu, Xu, Xu, Xu, Xu, Xu, Xu, Xu, Xu, Qxu, Xu, Xu, Xu, Xu, Xu, Xu, Xu, Xu, Xu, Xu, Xu, Xu, Xu, Xu, Xu, Xu, Xu, Xu, Xu
Mm, Qxu, Qxu, Mm, Mm^Xm, Mm^Xm, Xu, Xu, Xu, Xu, Xu, Xu, Mm^Xm, Mm^Xm, Mm, Mm^Xm, Mm, Mm, Mm^Xm, Mm^Xm, Mm, Mm, Mm, Mm^Xm, Mm^Xm, Mm^Xm, Mm^Xm, Xu, Xu, Xu, Xu, Xu, Xu, Xu, Xu, Xu, Uhe, Xu, Uhe^Uf, Xu, Xu, Xu, Xu, Qxu, Qxu, Qxu, Qxu, Xu, Qxu, Xu, Xu, Xu, Xu, Xu, Qxu, Qxu, Qxu, Xu, Mm^Xm, Xu, Mm^Xm, Xu
Mm^Xm, Mm, Qxu, Mm, Mm, Mm^Xm, Xu, Xu, Xu, Xu, Xu, Mm, Mm, Mm^Xm, Mm, Mm, Hhd, Mm, Mm, Mm, Hhd, Mm, Mm, Mm, Mm, Mm, Mm^Xm, Mm^Xm, Mm^Xm, Xu, Xu, Xu, Xu, Xu, Uhe, Uhe^Uf, Uhe^Uf, Uhe^Uf, Uue^Uf, Uhe^Uf, Uhe, Uhe, Uue, Uu, Uu, Qxu, Qxu, Qxu, Uh, Xu, Cud, Xu, Qxu, Qxu, Xu, Xu, Mm^Xm, Mm, Mm, Mm^Xm, Mm, Mm^Xm
Mm^Xm, Mm^Xm, Qxu, Mm, Mm, Mm^Xm, Xu, Xu, Xu, Xu, Xu, Mm^Xm, Mm, Mm, Mm, Mm, Hh, Hh, Hh^Vhr, Hhd, Hhd, Mm, Hhd, Mm, Hh, Mm, Hhd, Mm, Hh, Mm, Mm, Xu, Xu, Xu, Rb, Uhe, Uue, Uue, Uue, Uue, Uue^Es, Uue, Urb, Uu, Rb, Rb, Rb, Uh, Uu, Cud, Cud, Cud, Cud, Xu, Xu, Xu, Mm, Mm, Gll^Fp, Mm, Wog, Mm
Xu, Mm^Xm, Mm^Xm, Qxu, Qxu, Xu, Xu, Xu, Uhe, Xu, Hhd, Hhd, Mm, Mm, Gd, Hh, Gg, Hhd^Es, Gg, Mm, Hh^Fmf, Hhd^Fmf, Gs^Fms, Hh^Fms, Hh^Fms, Hh, Hh^Fp, Hh^Fp, Gs, Mm, Gll^Fp, Gll^Fp, Gs, Gll, Gll, Rb, Uue, Uue, Uue, Uue, Rb, Uu, Rb, Urb, Urb, Urb, Urb, Urb, Urb, Cud, Cud, Kud, Cud, Xu, Xu, Xu, Xu, Mm, Wog, Wog, Wog, Wog
Xu, Xu, Xu, Xu, Xu, Qxu, Qxu, Uhe, Uhe, Uhe, Gd, Gd, Gd, Gd, Gd, Gg, Gd, Gg, Rd, Gg, Rd, Gs, Re, Gs, Gs, Gs, Gs, Gs, Gs, Gs^Fp, Gs, Gs, Rd, Rd, Rd, Rb, Uue, Uue, Uhe, Rb, Xu, Rb, Xu, Uu, Uue, Uue, Uu, Urb, Uu, Cud, Cud, Cud, Cud, Xu, Wwg^Xo, Xu, Wog, Wog, Wog, Wog, Gg, Wog
Xu, Xu, Xu, Xu, Xu, Qxu, Cud, Uhe, Uue, Uue, Re, Re, Hhd, Gd, Gg^Fms, Gd, Gll^Fmf, Gll^Fp, Gs, Rd, Re, Re, Re^Es, Gs, Re, Re, Re^Efm, Gs, Rd^Efm, Gs, Rd, Rd, Gs, Gd, Gll, Gll, Xu, Xu, Xu, Xu, Xu, Xu, Xu, Xu, Uhe^Uf, Uue, Uue, Uu, Rb, Qxu, Xu, Xu, Xu, Xu, Wog^Xo, Wog, Wog, Wog, Wog, Wog, Gg, Gg
Xu, Xu, Xu, Xu, Xu, Xu, Cud, Uhe, Uue, Re, Uue, Re, Re, Hhd^Fms, Hh^Fms, Hh^Fp, Hh^Fmf, Gll^Fp, Gll^Fp, Gg^Fet, Gs, Gs^Efm, Gs, Gs, Gg, Gd, Re, Gs^Efm, Gg, Rd^Es, Gs^Es, Gs, Gs, Gg, Mm, Mm, Xu, Xu, Xu, Xu, Xu, Xu, Xu, Xu, Uhe, Uue^Uf, Urb, Rb, Qxu, Qxu, Xu, Xu, Wog, Wog, Xu, Wog, Mm^Xm, Mm^Xm, Mm, Gs, Gs, Gg
Xu, Xu, Uhe^Uf, Uhe^Uf, Uh^Uf, Cud, Uh^Uf, Uh^Uf, Uue, Uue, Uue, Hhd, Mm, Gs, Mm, Hh^Fms, Mm, Gll, Hh^Fms, Gll^Fp, Hh^Fp, Gs, Gll^Fp, Gll^Fp, Gll, Gll, Gg, Gs, Gs, Gs, Gs, Gll^Fp, Gs^Fms, Mm, Mm, Mm^Xm, Mm^Xm, Xu, Xu, Xu, Xu, Xu, Xu, Uhe, Urb^Es, Uue, Uh, Qxu, Xu, Xu, Wog, Wog, Wog, Wog, Xu, Xu, Xu, Mm, Mm, Hh^Fp, Hh^Fp, Hh^Fp
Xu, Xu, Uhe, Uue, Uu^Vct, Uue, Uue, Uue, Uu^Uf, Uue, Xu, Mm, Mm^Xm, Mm, Mm, Mm, Mm, Hh, Hh, Hh^Fp, Hh^Fp, Hh^Fp, Hh^Fds, Gll^Fp, Rd^Fp, Gll^Fmf, Gll^Fmf, Gs, Gll, Gs, Gll^Fp, Gll^Fms, Hh^Fms, Gs^Fms, Hh, Mm, Mm^Xm, Mm^Xm, Xu, Xu, Xu, Xu, Uu, Urb, Rb, Uh, Uh, Qxu, Xu, Xu, Wog, Wog, Wog, Xu, Xu, Xu, Xu, Mm^Xm, Mm, Mm, Mm, Hh^Fp
Xu, Xu, Uh^Uf, Uu, Uu, Uu, Ur, Ur, Uu, Xu, Xu, Xu, Xu, Mm^Xm, Mm^Xm, Mm, Mm, Mm, Mm, Mm, Mm, Hh, Hh, Hh^Fms, Hh, Hh, Hh, Hh, Hhd, Hh^Fp, Hh^Fp, Hh, Hh, Hh, Mm, Mm, Mm, Mm^Xm, Xu, Xu, Cud, Cud, Cud, Urb, Rb^Uf, Uh^Uf, Xu, Xu, Wog, Wog, Wog, Wog, Xu, Xu, Xu, Xu, Xu, Xu, Mm^Xm, Mm, Mm, Mm
Xu, Xu, Xu, Uh, Uu, Ur, Uue, Uu, Xu, Xu, Xu, Xu, Mm^Xm, Xu, Xu, Mm^Xm, Mm^Xm, Mm, Mm, Mm, Mm, Mm, Mm, Hh, Mm, Hh^Dr, Mm, Mm, Mm, Hhd, Mm, Mm, Mm, Mm, Mm, Mm, Mm, Xu, Xu, Xu, Uu, Cud, Cud, Cud, Cud, Xu, Xu, Xu, Wog, Wog, Xu, Xu, Xu, Xu, Xu, Xu, Xu, Xu, Mm^Xm, Mm, Mm^Xm, Mm
Xu, Xu, Uu, Xu, Cud, Cud, Cud, Uu, Xu, Xu, Mm^Xm, Mm^Xm, Mm^Xm, Mm^Xm, Mm^Xm, Xu, Xu, Mm^Xm, Mm^Xm, Mm, Mm, Mm, Mm, Mm, Mm, Mm, Mm, Mm, Mm^Xm, Mm, Mm^Xm, Mm^Xm, Mm^Xm, Mm^Xm, Mm^Xm, Mm^Xm, Xu, Xu, Uu, Uu, Urb, Urb, Uu, Cud, Xu, Xu, Xu, Wog, Wog, Xu, Xu, Xu, Mm^Xm, Xu, Xu, Xu, Xu, Xu, Xu, Mm^Xm, Xu, Mm^Xm
Xu, Xu, Cud, Cud, Cud, 2 Kud, Xu, Xu, Mm, Mm, Mm, Mm, Mm, Mm, Mm, Mm^Xm, Mm^Xm, Xu, Xu, Mm^Xm, Mm^Xm, Mm, Mm^Xm, Mm, Mm^Xm, Mm^Xm, Mm^Xm, Mm^Xm, Mm^Xm, Mm^Xm, Xu, Mm^Xm, Xu, Mm^Xm, Xu, Xu, Xu, Xu, Uu, Urb, Uu, Uu, Xu, Xu, Xu, Xu, Wog, Wog, Xu, Xu, Mm^Xm, Mm^Xm, Mm, Mm, Mm, Xu, Xu, Xu, Xu, Xu, Xu, Xu
Xu, Uu, Xu, Uue, Uue, Cud, Xu, Mm, Mm, Mm, Hh, Mm, Hh, Mm, Mm, Mm, Mm, Mm^Xm, Mm^Xm, Xu, Xu, Mm^Xm, Mm^Xm, Mm^Xm, Xu, Mm^Xm, Xu, Mm^Xm, Xu, Xu, Xu, Xu, Xu, Xu, Qxu, Qxu, Urb, Urb, Urb, Urb^Uf, Uu^Uf, Xu, Xu, Xu, Mm^Xm, Mm^Xm, Wog, Wog, Mm^Xm, Mm^Xm, Mm^Xm, Mm^Xm, Mm, Mm^Xm, Mm, Mm, Mm^Xm, Xu, Xu, Xu, Xu, Xu
Xu, Xu, Uu^Vct, Uue, Ur, Uue, Hhd, Mm, Gg, Gg, Hh, Hh, Hh, Hh, Mm, Mm, Mm, Mm, Mm^Xm, Mm^Xm, Mm^Xm, Xu, Xu, Xu, Xu, Xu, Xu, Xu, Xos, Xos, Xu, Xu, Qxu, Qxu, Qxu, Qxu, Urb, Urb^Es, Uu, Uu^Uf, Xu, Xu, Mm^Xm, Mm^Xm, Mm, Mm, Wog^Xo, Wog^Xo, Mm, Mm, Mm, Mm, Mm, Mm, Mm, Mm, Mm, Mm^Xm, Mm^Xm, Xu, Xu, Xu
Xu, Xu, Uu, Uue, Uu, Uue, Hhd, Gd, Gd, Gg, Gg, Gg, Gg, Hh, Hh, Hh, Mm, Mm, Mm, Mm^Xm, Mm^Xm, Xu, Xu, Xu, Xu, Xu, Xos, Xos, Cud, Cud, Cud, Xu, Qxu, Uu, Urb, Urb, Uu, Uu, Xu, Xu, Xu, Mm^Xm, Mm, Mm^Xm, Mm, Mm, Wog, Wog, Mm, Mm, Hh, Mm, Mm, Mm, Mm, Mm, Mm, Mm, Mm^Xm, Mm^Xm, Mm^Xm, Xu
Xu, Uh^Uf, Uh^Uf, Ur, Uu^Vu, Hhd, Mm, Gd, Gd, Gg, Gd, Gg, Rd, Hh, Hh, Hh, Hh, Mm, Mm, Mm, Mm^Xm, Xu, Xu, Xu, Xu, Xos, Xu, Cud, Cud, Cud, Urb, Uu, Uu, Urb, Uu, Uu, Qxu, Qxu, Xu, Xu, Xu, Mm^Xm, Mm^Xm, Mm, Mm, Mm, Wog, Wog, Wog, Hh, Hh, Mm, Hhd, Mm, Mm, Mm, Mm, Mm, Mm, Mm^Xm, Mm^Xm, Mm^Xm
Xu, Xu, Qxu, Ur, Xu, Xu, Mm^Xm, Hh, Hh, Gd, Gd, Rd, Gs^Es, Gs^Es, Hh, Hh, Mm, Mm, Mm, Mm^Xm, Mm^Xm, Xu, Xu, Xu, Xu, Xu, Xu, Xu, Uh^Uf, Uu, Urb, Urb, Urb, Urb, Uu, Uh, Xu, Xu, Xu, Xu, Mm^Xm, Mm^Xm, Mm, Mm, Hh^Fp, Hh, Hh, Wog, Wog, Hh, Hh, Hh^Fms, Gd^Fms, Hhd, Hhd, Hhd^Vhr, Hhd, Mm, Mm, Mm, Mm^Xm, Gg
Qxu, Qxu, Qxu, Xuc, Xu, Mm^Xm, Mm^Xm, Mm, Hh, Gd, Gs^Es, Rd, Gs, Gs^Efm, Hh, Hh, Hh, Mm, Mm^Xm, Mm^Xm, Mm, Mm^Xm, Mm^Xm, Xu, Xu, Xu, Xu, Xu, Uh^Uf, 4 Uu, Urb, Urb, Urb, Urb^Es, Uu, Xu, Xu, Xu, Mm^Xm, Mm^Xm, Mm, Mm, Hh^Fms, Hh^Fp, Hh^Fp, Hh^Fp, Gg, Gg, Wog, Wog, Gg, Gg^Es, Gll, Hh, Gs, Hhd, Gll^Fms, Hh^Fp, Hh^Fp, Mm^Xm, Mm^Xm, Gg
Xu, Xu, Xu, Xu, Mm^Xm, Mm, Mm, Hh, Hh, Hh, Gs, Rd, Gs, Gg, Gg, Hh, Hh, Mm, Mm^Xm, Mm, Hhd, Mm, Mm^Xm, Xu, Xu, Qxu, Xu, Xu, Xu, Uu, Uu^Vct, Urb, Uu, Urb, Urb, Xu, Xu, Mm^Xm, Mm, Mm, Hh, Hh, Gg^Fms, Gg^Fp, Gg^Fms, Gll^Fp, Gs^Efm, Gg, Gg, Wog, Gg, Gg, Gs, Gs, Gd^Fdf, Gs^Fms, Gs^Fms, Gs^Fms, Hh^Fp, Mm, Mm, Mm^Xm
Xu, Xu, Mm^Xm, Mm, Mm^Xm, Mm, Hhd, Hhd, Mm, Hhd, Hhd^Es, Rd, Gs, Gg, Mm, Hh, Mm^Xm, Mm, Mm^Xm, Mm, Hhd^Fp, Mm, Mm, Xu, Xu, Qxu, Qxu, Qxu, Xu, Xu, Xu, Uu, Ur, Uu, Uu, Uu^Vud, Xu, Mm^Xm, Hh, Hh, Hh^Fms, Gg^Fms, Gs^Fms, Gll^Fp, Gll^Fp, Gll^Fp, Gs, Gs^Efm, Gll^Fp, Wog, Wog, Gg, Re, Gll^Fp, Re, Gd^Fdf, Re, Gll^Fmf, Gll^Fdf, Hh, Hh, Hh
Mm^Xm, Mm, Mm^Xm, Mm^Xm, Mm, Mm, Mm, Mm, Hh, Hhd, Gs, Rd, Gs, Gg, Hh, Mm, Mm^Xm, Mm^Xm, Mm, Mm, Hh, Hhd^Fp, Mm, Mm^Xm, Xu, Xu, Qxu, Qxu, Cud, Xu, Cud, Uu, Uu, Ur, Uu, Uu, Xu, Mm, Hh, Hh, Hh, Hh^Fms, Re^Fp, Gll^Fp, Gs^Fp, Gll^Fp, Gs, Gs, Gs, Gll^Fp, Wwf^Bw/, Re, Gs, Re, Gll^Fp, Re, Gll^Fmf, Re, Re, Gll, Gs, Gll
Mm^Xm, Mm, Mm, Mm^Xm, Mm, Mm, Mm, Gd, Gs, Gs, Gg^Fp, Rd, Gs, Gs^Efm, Gs^Efm, Mm^Xm, Mm, Mm^Xm, Hh, Hh, Mm, Hh, Mm, Mm^Xm, Xu, Xu, Qxu, Qxu, Cud, Cud, Cud, Uu, Uu^Es, Ur^Es, Uu, Uu, Xu, Mm, Gg, Hh, Ds, Gs, Re, Gs^Es, Re, Gs, Re, Gg, Re, Re, Wog, Gs, Gs^Efm, Gll^Fp, Gll^Fp, Gll^Fp, Gll^Fp, Gll^Fp, Gs, Re, Re, Re
Mm, Mm^Xm, Mm, Mm, Mm, Hh, Hh, Mm, Gs, Gg^Fp, Rd^Fms, Rd^Fp, Gg^Fp, Gs, Gs^Fms, Hh^Fms, Hh^Fms, Hh, Hh, Hh, Mm^Xm, Mm, Mm, Mm^Xm, Xu, Qxu, Qxu, Xu, Kud, Cud, Urb, Uu, Ur, Ur^Es, Uu, Cud, Gg, Gg, Gg^Es, Gg, Gd, Gs, Gg, Re, Gs, Re, Gg, Re, Gg^Efm, Gs^Es, Wog, Gg, Gg, Gs, Gg, Gll^Fp, Gg, Gs^Fms, Gd, Gd, Gg, Gll^Es
Mm^Xm, Mm, Hh, Hh, Gd, Gd, Gs^Efm, Gs^Fms, Gs^Fds, Rd^Fds, Gll^Fmf, Gll^Fmf, Gg^Fms, Gs, Hh, Hh^Fp, Hhd^Fmf, Hh, Mm, Mm^Xm, Mm, Mm, Mm^Xm, Mm^Xm, Xu, Xu, Cud, Cud, Cud, Urb, Urb, Uu, Ur, Uu, Ur, Uu, Gs, Gs, Gd, Rb, Hhd, Gd, Gd, Gs^Fms, Gll^Fmf, Gs, Gg, Gg^Efm, Gg^Efm, Gg, Wog, Wog, Wog, Gg, Gs, Gg^Es, Gg, Gg^Efm, Gg^Efm, Gg, Gg, Gg
Mm, Mm^Xm, Hhd^Fdf, Gs^Fms, Gs^Es, Gs^Es, Gs^Es, Gll^Fmf, Rd, Rd^Fds, Gg^Fms, Gs^Fms, Gs^Es, Gs, Gs^Es, Hh^Fp, Mm, Hh, Mm^Xm, Mm^Xm, Mm^Xm, Mm, Mm, Mm^Xm, Xu, Xu, Cud, Cud, Cud, Urb, Uu, Uu, Ur, Ur, Uu, Uu, Rb, Gs^Fms, Hhd^Fp, Hhd, Hh, Hh, Hh, Gs^Fms, Hh^Fp, Gll^Fp, Gll^Fp, Gg, Gg, Gs, Gs, Gg, Gg, Wog, Wog, Gs, Gg, Gs^Efm, Gs, Gs^Efm, Gs, Gg
Mm, Mm, Hhd^Fdf, Hhd^Fmf, Rd, Rd, Rd, Rd, Gs^Efm, Gll^Fp, Gs^Fms, Gs^Fds, Gll^Fmf, Gs^Es, Gs^Efm, Mm, Hh, Hh, Mm, Mm, Mm^Xm, Mm^Xm, Mm, Mm^Xm, Xu, Xu, Xu, Cud, Uu, Uu, Uu^Uf, Ur, Uu, Uu, Uu, Cud, Gg, Hhd^Fmf, Gll^Fp, Hh^Fp, Hh^Fp, Hhd^Fp, Hh^Fp, Hh, Hhd^Fp, Gll^Fp, Gll^Fp, Gll^Fp, Gll^Fp, Gs, Gll^Fp, Gg, Gs, Gg, Wog, Gg, Gg, Gs, Gll^Fp, Gg, Gs, Gg
Hh, Hh, Gll^Fp, Gll^Fp, 1 Rd, Rd, Gd, Gs, Gs^Efm, Hh^Fds, Hhd^Fdf, Hhd^Fmf, Hh, Hh, Gs, Gd, Hh, Hh, Hh, Mm^Xm, Mm, Mm^Xm, Mm^Xm, Mm^Xm, Mm^Xm, Xu, Xu, Xu, Xu, Uu^Uf, Xu, Ur^Uf, Uu, Uu^Vud, Xu, Mm, Mm, Hh, Mm, Hh^Fp, Mm, Hh^Fds, Mm, Hhd^Fp, Hh, Hh, Hh, Hh^Fp, Gll^Fp, Gll^Fp, Gll^Fp, Gll^Fp, Gs, Gs, Wog, Wog, Gg, Gll^Fp, Gll^Fp, Gg, Gg, Gg
Gs, Gs, Gs, Gs, Rd, Gs, Gd, Hh, Hhd^Fmf, Hh^Fms, Hh^Fds, Hhd^Fdf, Mm, Mm, Gd, Gd, Gd, Mm, Mm, Mm, Mm, Mm, Mm^Xm, Mm^Xm, Mm^Xm, Xu, Xu, Xu, Xu, Xu, Xu, Xu, Xu, Xu, Xu, Mm^Xm, Mm^Xm, Mm, Mm, Mm, Mm, Mm, Mm, Mm, Mm, Mm, Hh, Hh, Hh, Gll^Fp, Hh, Gg, Gg, Gs, Wog, Wog, Wog, Gg, Gs, Gll^Fp, Gll^Fp, Gg
Gs, Gs, Rd, Rd, Gs, Gs, Hh, Hh, Mm, Mm, Mm, Mm, Mm, Mm, Mm, Gd, Mm^Xm, Mm, Mm^Xm, Mm^Xm, Gg, Mm^Xm, Mm^Xm, Mm, Mm^Xm, Mm^Xm, Xu, Xu, Xu, Xu, Xu, Xu, Xu, Xu, Mm^Xm, Mm^Xm, Mm, Mm, Mm, Mm, Mm, Mm, Mm, Mm, Mm, Mm, Mm, Hh, Gg, Hh, Gg, Hh, Gg, Gg, Gg, Wog, Wog, Wog, Gg, Gg, Gg, Gg
